*********** # 1 **************
PokerStars Hand #197158580020:  Hold'em No Limit ($0.01/$0.02 USD) - 2019/02/17 7:51:56 ET
Table 'Coppelia III' 6-max Seat #3 is the button
Seat 1: Ganseku Nagi ($2.67 in chips)
Seat 2: Charlie44333 ($2.16 in chips)
Seat 3: professor190 ($2.13 in chips)
Seat 4: BB_tape112 ($2.08 in chips)
Seat 5: Soranton ($2.87 in chips)
Seat 6: Benzer586 ($2.14 in chips)
BB_tape112: posts small blind $0.01
Soranton: posts big blind $0.02
*** HOLE CARDS ***
Dealt to Benzer586 [3h 4h]
Benzer586: folds
Ganseku Nagi: folds
Charlie44333: folds
Benzer586 leaves the table
professor190: folds
BB_tape112: raises $0.02 to $0.04
Soranton: folds
Uncalled bet ($0.02) returned to BB_tape112
BB_tape112 collected $0.04 from pot
BB_tape112: doesn't show hand
*** SUMMARY ***
Total pot $0.04 | Rake $0
Seat 1: Ganseku Nagi folded before Flop (didn't bet)
Seat 2: Charlie44333 folded before Flop (didn't bet)
Seat 3: professor190 (button) folded before Flop (didn't bet)
Seat 4: BB_tape112 (small blind) collected ($0.04)
Seat 5: Soranton (big blind) folded before Flop
Seat 6: Benzer586 folded before Flop (didn't bet)


*********** # 2 **************
PokerStars Hand #197158539053:  Hold'em No Limit ($0.01/$0.02 USD) - 2019/02/17 7:50:30 ET
Table 'Coppelia III' 6-max Seat #2 is the button
Seat 1: Ganseku Nagi ($2.67 in chips)
Seat 2: Charlie44333 ($2.48 in chips)
Seat 3: professor190 ($2.14 in chips)
Seat 4: BB_tape112 ($2.10 in chips)
Seat 5: Soranton ($2.87 in chips)
Seat 6: Benzer586 ($1.81 in chips)
professor190: posts small blind $0.01
BB_tape112: posts big blind $0.02
*** HOLE CARDS ***
Dealt to Benzer586 [Th Tc]
Soranton: folds
Benzer586: raises $0.02 to $0.04
Ganseku Nagi: folds
Charlie44333: raises $0.12 to $0.16
professor190: folds
BB_tape112: folds
Benzer586: calls $0.12
*** FLOP *** [4h Ad 7d]
Benzer586: checks
Charlie44333: checks
*** TURN *** [4h Ad 7d] [4c]
Benzer586: bets $0.04
Charlie44333: calls $0.04
*** RIVER *** [4h Ad 7d 4c] [Td]
Benzer586: bets $0.12
Charlie44333: calls $0.12
*** SHOW DOWN ***
Benzer586: shows [Th Tc] (a full house, Tens full of Fours)
Charlie44333: mucks hand
Benzer586 collected $0.65 from pot
*** SUMMARY ***
Total pot $0.67 | Rake $0.02
Board [4h Ad 7d 4c Td]
Seat 1: Ganseku Nagi folded before Flop (didn't bet)
Seat 2: Charlie44333 (button) mucked [Kc Kd]
Seat 3: professor190 (small blind) folded before Flop
Seat 4: BB_tape112 (big blind) folded before Flop
Seat 5: Soranton folded before Flop (didn't bet)
Seat 6: Benzer586 showed [Th Tc] and won ($0.65) with a full house, Tens full of Fours


*********** # 3 **************
PokerStars Hand #197158524610:  Hold'em No Limit ($0.01/$0.02 USD) - 2019/02/17 7:49:59 ET
Table 'Coppelia III' 6-max Seat #1 is the button
Seat 1: Ganseku Nagi ($2.67 in chips)
Seat 2: Charlie44333 ($2.49 in chips)
Seat 3: professor190 ($2.16 in chips)
Seat 4: BB_tape112 ($2.10 in chips)
Seat 5: Soranton ($2.87 in chips)
Seat 6: Benzer586 ($1.78 in chips)
Charlie44333: posts small blind $0.01
professor190: posts big blind $0.02
*** HOLE CARDS ***
Dealt to Benzer586 [Qc Jc]
BB_tape112: folds
Soranton: folds
Benzer586: raises $0.04 to $0.06
Ganseku Nagi: folds
Charlie44333: folds
professor190: folds
Uncalled bet ($0.04) returned to Benzer586
Benzer586 collected $0.05 from pot
Benzer586: doesn't show hand
*** SUMMARY ***
Total pot $0.05 | Rake $0
Seat 1: Ganseku Nagi (button) folded before Flop (didn't bet)
Seat 2: Charlie44333 (small blind) folded before Flop
Seat 3: professor190 (big blind) folded before Flop
Seat 4: BB_tape112 folded before Flop (didn't bet)
Seat 5: Soranton folded before Flop (didn't bet)
Seat 6: Benzer586 collected ($0.05)


*********** # 4 **************
PokerStars Hand #197158496167:  Hold'em No Limit ($0.01/$0.02 USD) - 2019/02/17 7:49:00 ET
Table 'Coppelia III' 6-max Seat #6 is the button
Seat 1: Ganseku Nagi ($2.83 in chips)
Seat 2: Charlie44333 ($2.34 in chips)
Seat 3: professor190 ($2.16 in chips)
Seat 4: BB_tape112 ($2.10 in chips)
Seat 5: Soranton ($2.87 in chips)
Seat 6: Benzer586 ($1.78 in chips)
Ganseku Nagi: posts small blind $0.01
Charlie44333: posts big blind $0.02
*** HOLE CARDS ***
Dealt to Benzer586 [7c 4s]
professor190: folds
BB_tape112: folds
Soranton: folds
Benzer586: folds
Ganseku Nagi: raises $0.04 to $0.06
Charlie44333: calls $0.04
*** FLOP *** [Ah Js Qd]
Ganseku Nagi: bets $0.10
Charlie44333: calls $0.10
*** TURN *** [Ah Js Qd] [2c]
Ganseku Nagi: checks
Charlie44333: checks
*** RIVER *** [Ah Js Qd 2c] [3s]
Ganseku Nagi: checks
Charlie44333: bets $0.16
Ganseku Nagi: folds
Uncalled bet ($0.16) returned to Charlie44333
Charlie44333 collected $0.31 from pot
Charlie44333: doesn't show hand
*** SUMMARY ***
Total pot $0.32 | Rake $0.01
Board [Ah Js Qd 2c 3s]
Seat 1: Ganseku Nagi (small blind) folded on the River
Seat 2: Charlie44333 (big blind) collected ($0.31)
Seat 3: professor190 folded before Flop (didn't bet)
Seat 4: BB_tape112 folded before Flop (didn't bet)
Seat 5: Soranton folded before Flop (didn't bet)
Seat 6: Benzer586 (button) folded before Flop (didn't bet)


*********** # 5 **************
PokerStars Hand #197158471967:  Hold'em No Limit ($0.01/$0.02 USD) - 2019/02/17 7:48:09 ET
Table 'Coppelia III' 6-max Seat #5 is the button
Seat 1: Ganseku Nagi ($2.88 in chips)
Seat 2: Charlie44333 ($2.34 in chips)
Seat 3: professor190 ($2.16 in chips)
Seat 4: BB_tape112 ($2.01 in chips)
Seat 5: Soranton ($2.87 in chips)
Seat 6: Benzer586 ($1.83 in chips)
Benzer586: posts small blind $0.01
Ganseku Nagi: posts big blind $0.02
*** HOLE CARDS ***
Dealt to Benzer586 [8s Ah]
Charlie44333: folds
professor190: folds
BB_tape112: raises $0.03 to $0.05
Soranton: folds
Benzer586: calls $0.04
Ganseku Nagi: calls $0.03
*** FLOP *** [3h 9h 7h]
Benzer586: checks
Ganseku Nagi: checks
BB_tape112: checks
*** TURN *** [3h 9h 7h] [Ks]
Benzer586: checks
Ganseku Nagi: checks
BB_tape112: bets $0.08
Benzer586: folds
Ganseku Nagi: folds
Uncalled bet ($0.08) returned to BB_tape112
BB_tape112 collected $0.14 from pot
BB_tape112: doesn't show hand
*** SUMMARY ***
Total pot $0.15 | Rake $0.01
Board [3h 9h 7h Ks]
Seat 1: Ganseku Nagi (big blind) folded on the Turn
Seat 2: Charlie44333 folded before Flop (didn't bet)
Seat 3: professor190 folded before Flop (didn't bet)
Seat 4: BB_tape112 collected ($0.14)
Seat 5: Soranton (button) folded before Flop (didn't bet)
Seat 6: Benzer586 (small blind) folded on the Turn


*********** # 6 **************
PokerStars Hand #197158462741:  Hold'em No Limit ($0.01/$0.02 USD) - 2019/02/17 7:47:50 ET
Table 'Coppelia III' 6-max Seat #4 is the button
Seat 1: Ganseku Nagi ($2.88 in chips)
Seat 2: Charlie44333 ($2.34 in chips)
Seat 3: professor190 ($2.16 in chips)
Seat 4: BB_tape112 ($2.01 in chips)
Seat 5: Soranton ($2.88 in chips)
Seat 6: Benzer586 ($1.82 in chips)
Soranton: posts small blind $0.01
Benzer586: posts big blind $0.02
*** HOLE CARDS ***
Dealt to Benzer586 [Qh Ts]
Ganseku Nagi: folds
Charlie44333: folds
professor190: folds
BB_tape112: folds
Soranton: folds
Uncalled bet ($0.01) returned to Benzer586
Benzer586 collected $0.02 from pot
Benzer586: doesn't show hand
*** SUMMARY ***
Total pot $0.02 | Rake $0
Seat 1: Ganseku Nagi folded before Flop (didn't bet)
Seat 2: Charlie44333 folded before Flop (didn't bet)
Seat 3: professor190 folded before Flop (didn't bet)
Seat 4: BB_tape112 (button) folded before Flop (didn't bet)
Seat 5: Soranton (small blind) folded before Flop
Seat 6: Benzer586 (big blind) collected ($0.02)


*********** # 7 **************
PokerStars Hand #197158449426:  Hold'em No Limit ($0.01/$0.02 USD) - 2019/02/17 7:47:25 ET
Table 'Coppelia III' 6-max Seat #3 is the button
Seat 1: Ganseku Nagi ($2.94 in chips)
Seat 2: Charlie44333 ($2.34 in chips)
Seat 3: professor190 ($2.07 in chips)
Seat 4: BB_tape112 ($2.02 in chips)
Seat 5: Soranton ($2.90 in chips)
Seat 6: Benzer586 ($1.82 in chips)
BB_tape112: posts small blind $0.01
Soranton: posts big blind $0.02
*** HOLE CARDS ***
Dealt to Benzer586 [2s Kc]
Benzer586: folds
Ganseku Nagi: raises $0.04 to $0.06
Charlie44333: folds
professor190: raises $0.12 to $0.18
BB_tape112: folds
Soranton: folds
Ganseku Nagi: folds
Uncalled bet ($0.12) returned to professor190
professor190 collected $0.15 from pot
*** SUMMARY ***
Total pot $0.15 | Rake $0
Seat 1: Ganseku Nagi folded before Flop
Seat 2: Charlie44333 folded before Flop (didn't bet)
Seat 3: professor190 (button) collected ($0.15)
Seat 4: BB_tape112 (small blind) folded before Flop
Seat 5: Soranton (big blind) folded before Flop
Seat 6: Benzer586 folded before Flop (didn't bet)


*********** # 8 **************
PokerStars Hand #197158443446:  Hold'em No Limit ($0.01/$0.02 USD) - 2019/02/17 7:47:12 ET
Table 'Coppelia III' 6-max Seat #2 is the button
Seat 1: Ganseku Nagi ($2.94 in chips)
Seat 2: Charlie44333 ($2.31 in chips)
Seat 3: professor190 ($2.08 in chips)
Seat 4: BB_tape112 ($2.04 in chips)
Seat 5: Soranton ($2.90 in chips)
Seat 6: Benzer586 ($1.82 in chips)
professor190: posts small blind $0.01
BB_tape112: posts big blind $0.02
*** HOLE CARDS ***
Dealt to Benzer586 [Kd 3c]
Soranton: folds
Benzer586: folds
Ganseku Nagi: folds
Charlie44333: raises $0.03 to $0.05
professor190: folds
BB_tape112: folds
Uncalled bet ($0.03) returned to Charlie44333
Charlie44333 collected $0.05 from pot
Charlie44333: doesn't show hand
*** SUMMARY ***
Total pot $0.05 | Rake $0
Seat 1: Ganseku Nagi folded before Flop (didn't bet)
Seat 2: Charlie44333 (button) collected ($0.05)
Seat 3: professor190 (small blind) folded before Flop
Seat 4: BB_tape112 (big blind) folded before Flop
Seat 5: Soranton folded before Flop (didn't bet)
Seat 6: Benzer586 folded before Flop (didn't bet)


*********** # 9 **************
PokerStars Hand #197158432825:  Hold'em No Limit ($0.01/$0.02 USD) - 2019/02/17 7:46:50 ET
Table 'Coppelia III' 6-max Seat #1 is the button
Seat 1: Ganseku Nagi ($2.98 in chips)
Seat 2: Charlie44333 ($2.32 in chips)
Seat 3: professor190 ($2.03 in chips)
Seat 5: Soranton ($2.90 in chips)
Seat 6: Benzer586 ($1.82 in chips)
Charlie44333: posts small blind $0.01
professor190: posts big blind $0.02
*** HOLE CARDS ***
Dealt to Benzer586 [2s 7d]
Soranton: folds
Benzer586: folds
Ganseku Nagi: raises $0.02 to $0.04
Charlie44333: folds
professor190: raises $0.08 to $0.12
Ganseku Nagi: folds
Uncalled bet ($0.08) returned to professor190
professor190 collected $0.09 from pot
*** SUMMARY ***
Total pot $0.09 | Rake $0
Seat 1: Ganseku Nagi (button) folded before Flop
Seat 2: Charlie44333 (small blind) folded before Flop
Seat 3: professor190 (big blind) collected ($0.09)
Seat 5: Soranton folded before Flop (didn't bet)
Seat 6: Benzer586 folded before Flop (didn't bet)


*********** # 10 **************
PokerStars Hand #197158427519:  Hold'em No Limit ($0.01/$0.02 USD) - 2019/02/17 7:46:39 ET
Table 'Coppelia III' 6-max Seat #6 is the button
Seat 1: Ganseku Nagi ($2.96 in chips)
Seat 2: Charlie44333 ($2.34 in chips)
Seat 3: professor190 ($2.03 in chips)
Seat 5: Soranton ($2.90 in chips)
Seat 6: Benzer586 ($1.82 in chips)
Ganseku Nagi: posts small blind $0.01
Charlie44333: posts big blind $0.02
*** HOLE CARDS ***
Dealt to Benzer586 [5d Ts]
professor190: folds
Soranton: folds
Benzer586: folds
Ganseku Nagi: raises $0.04 to $0.06
Charlie44333: folds
Uncalled bet ($0.04) returned to Ganseku Nagi
Ganseku Nagi collected $0.04 from pot
Ganseku Nagi: doesn't show hand
*** SUMMARY ***
Total pot $0.04 | Rake $0
Seat 1: Ganseku Nagi (small blind) collected ($0.04)
Seat 2: Charlie44333 (big blind) folded before Flop
Seat 3: professor190 folded before Flop (didn't bet)
Seat 5: Soranton folded before Flop (didn't bet)
Seat 6: Benzer586 (button) folded before Flop (didn't bet)


*********** # 11 **************
PokerStars Hand #197158422766:  Hold'em No Limit ($0.01/$0.02 USD) - 2019/02/17 7:46:29 ET
Table 'Coppelia III' 6-max Seat #5 is the button
Seat 1: Ganseku Nagi ($2.95 in chips)
Seat 2: Charlie44333 ($2.34 in chips)
Seat 3: professor190 ($2.03 in chips)
Seat 5: Soranton ($2.90 in chips)
Seat 6: Benzer586 ($1.83 in chips)
Benzer586: posts small blind $0.01
Ganseku Nagi: posts big blind $0.02
*** HOLE CARDS ***
Dealt to Benzer586 [8c Tc]
Charlie44333: folds
professor190: folds
Soranton: folds
Benzer586: folds
Uncalled bet ($0.01) returned to Ganseku Nagi
Ganseku Nagi collected $0.02 from pot
Ganseku Nagi: doesn't show hand
*** SUMMARY ***
Total pot $0.02 | Rake $0
Seat 1: Ganseku Nagi (big blind) collected ($0.02)
Seat 2: Charlie44333 folded before Flop (didn't bet)
Seat 3: professor190 folded before Flop (didn't bet)
Seat 5: Soranton (button) folded before Flop (didn't bet)
Seat 6: Benzer586 (small blind) folded before Flop


*********** # 12 **************
PokerStars Hand #197158414954:  Hold'em No Limit ($0.01/$0.02 USD) - 2019/02/17 7:46:12 ET
Table 'Coppelia III' 6-max Seat #3 is the button
Seat 1: Ganseku Nagi ($2.95 in chips)
Seat 2: Charlie44333 ($2.34 in chips)
Seat 3: professor190 ($2 in chips)
Seat 5: Soranton ($2.91 in chips)
Seat 6: Benzer586 ($1.85 in chips)
Soranton: posts small blind $0.01
Benzer586: posts big blind $0.02
*** HOLE CARDS ***
Dealt to Benzer586 [6s Kh]
Ganseku Nagi: folds
Charlie44333: folds
professor190: raises $0.04 to $0.06
Soranton: folds
Benzer586: folds
Uncalled bet ($0.04) returned to professor190
professor190 collected $0.05 from pot
*** SUMMARY ***
Total pot $0.05 | Rake $0
Seat 1: Ganseku Nagi folded before Flop (didn't bet)
Seat 2: Charlie44333 folded before Flop (didn't bet)
Seat 3: professor190 (button) collected ($0.05)
Seat 5: Soranton (small blind) folded before Flop
Seat 6: Benzer586 (big blind) folded before Flop


*********** # 13 **************
PokerStars Hand #197158407733:  Hold'em No Limit ($0.01/$0.02 USD) - 2019/02/17 7:45:57 ET
Table 'Coppelia III' 6-max Seat #2 is the button
Seat 1: Ganseku Nagi ($2.95 in chips)
Seat 2: Charlie44333 ($2.34 in chips)
Seat 3: professor190 ($2 in chips)
Seat 5: Soranton ($2.90 in chips)
Seat 6: Benzer586 ($1.85 in chips)
professor190: posts small blind $0.01
Soranton: posts big blind $0.02
*** HOLE CARDS ***
Dealt to Benzer586 [Ad 8s]
Benzer586: folds
Ganseku Nagi: folds
Charlie44333: folds
professor190: folds
Uncalled bet ($0.01) returned to Soranton
Soranton collected $0.02 from pot
Soranton: doesn't show hand
*** SUMMARY ***
Total pot $0.02 | Rake $0
Seat 1: Ganseku Nagi folded before Flop (didn't bet)
Seat 2: Charlie44333 (button) folded before Flop (didn't bet)
Seat 3: professor190 (small blind) folded before Flop
Seat 5: Soranton (big blind) collected ($0.02)
Seat 6: Benzer586 folded before Flop (didn't bet)


*********** # 14 **************
PokerStars Hand #197158400446:  Hold'em No Limit ($0.01/$0.02 USD) - 2019/02/17 7:45:42 ET
Table 'Coppelia III' 6-max Seat #1 is the button
Seat 1: Ganseku Nagi ($2.92 in chips)
Seat 2: Charlie44333 ($2.35 in chips)
Seat 3: professor190 ($2 in chips)
Seat 5: Soranton ($2.90 in chips)
Seat 6: Benzer586 ($1.85 in chips)
Charlie44333: posts small blind $0.01
professor190: posts big blind $0.02
*** HOLE CARDS ***
Dealt to Benzer586 [3s 9h]
Soranton: folds
Benzer586: folds
Ganseku Nagi: raises $0.02 to $0.04
Charlie44333: folds
professor190: folds
Uncalled bet ($0.02) returned to Ganseku Nagi
Ganseku Nagi collected $0.05 from pot
Ganseku Nagi: doesn't show hand
*** SUMMARY ***
Total pot $0.05 | Rake $0
Seat 1: Ganseku Nagi (button) collected ($0.05)
Seat 2: Charlie44333 (small blind) folded before Flop
Seat 3: professor190 (big blind) folded before Flop
Seat 5: Soranton folded before Flop (didn't bet)
Seat 6: Benzer586 folded before Flop (didn't bet)


*********** # 15 **************
PokerStars Hand #197158390785:  Hold'em No Limit ($0.01/$0.02 USD) - 2019/02/17 7:45:22 ET
Table 'Coppelia III' 6-max Seat #6 is the button
Seat 1: Ganseku Nagi ($2.93 in chips)
Seat 2: Charlie44333 ($2.34 in chips)
Seat 3: professor190 ($2 in chips)
Seat 4: BB_tape112 ($2.04 in chips)
Seat 5: Soranton ($2.90 in chips)
Seat 6: Benzer586 ($1.85 in chips)
Ganseku Nagi: posts small blind $0.01
Charlie44333: posts big blind $0.02
*** HOLE CARDS ***
Dealt to Benzer586 [6s 2d]
professor190: folds
BB_tape112 has timed out
BB_tape112: folds
Soranton: folds
Benzer586: folds
Ganseku Nagi: folds
Uncalled bet ($0.01) returned to Charlie44333
Charlie44333 collected $0.02 from pot
Charlie44333: doesn't show hand
*** SUMMARY ***
Total pot $0.02 | Rake $0
Seat 1: Ganseku Nagi (small blind) folded before Flop
Seat 2: Charlie44333 (big blind) collected ($0.02)
Seat 3: professor190 folded before Flop (didn't bet)
Seat 4: BB_tape112 folded before Flop (didn't bet)
Seat 5: Soranton folded before Flop (didn't bet)
Seat 6: Benzer586 (button) folded before Flop (didn't bet)


*********** # 16 **************
PokerStars Hand #197158367283:  Hold'em No Limit ($0.01/$0.02 USD) - 2019/02/17 7:44:32 ET
Table 'Coppelia III' 6-max Seat #5 is the button
Seat 1: Ganseku Nagi ($2.86 in chips)
Seat 2: Charlie44333 ($2.34 in chips)
Seat 3: professor190 ($2 in chips)
Seat 4: BB_tape112 ($2.04 in chips)
Seat 5: Soranton ($2.96 in chips)
Seat 6: Benzer586 ($1.86 in chips)
Benzer586: posts small blind $0.01
Ganseku Nagi: posts big blind $0.02
*** HOLE CARDS ***
Dealt to Benzer586 [Kd 9h]
Charlie44333: folds
professor190: folds
BB_tape112 has timed out
BB_tape112: folds
Soranton: raises $0.04 to $0.06
Benzer586: folds
Ganseku Nagi: calls $0.04
*** FLOP *** [As Kh 4h]
Ganseku Nagi: checks
Soranton: checks
*** TURN *** [As Kh 4h] [3d]
Ganseku Nagi: bets $0.10
Soranton: folds
Uncalled bet ($0.10) returned to Ganseku Nagi
Ganseku Nagi collected $0.13 from pot
Ganseku Nagi: doesn't show hand
*** SUMMARY ***
Total pot $0.13 | Rake $0
Board [As Kh 4h 3d]
Seat 1: Ganseku Nagi (big blind) collected ($0.13)
Seat 2: Charlie44333 folded before Flop (didn't bet)
Seat 3: professor190 folded before Flop (didn't bet)
Seat 4: BB_tape112 folded before Flop (didn't bet)
Seat 5: Soranton (button) folded on the Turn
Seat 6: Benzer586 (small blind) folded before Flop


*********** # 17 **************
PokerStars Hand #197158355694:  Hold'em No Limit ($0.01/$0.02 USD) - 2019/02/17 7:44:08 ET
Table 'Coppelia III' 6-max Seat #4 is the button
Seat 1: Ganseku Nagi ($2.83 in chips)
Seat 2: Charlie44333 ($2.34 in chips)
Seat 3: professor190 ($2 in chips)
Seat 4: BB_tape112 ($2.04 in chips)
Seat 5: Soranton ($2.97 in chips)
Seat 6: Benzer586 ($1.88 in chips)
Soranton: posts small blind $0.01
Benzer586: posts big blind $0.02
*** HOLE CARDS ***
Dealt to Benzer586 [Jc 4h]
Ganseku Nagi: raises $0.04 to $0.06
Charlie44333: folds
professor190: folds
BB_tape112: folds
Soranton: folds
Benzer586: folds
Uncalled bet ($0.04) returned to Ganseku Nagi
Ganseku Nagi collected $0.05 from pot
Ganseku Nagi: doesn't show hand
*** SUMMARY ***
Total pot $0.05 | Rake $0
Seat 1: Ganseku Nagi collected ($0.05)
Seat 2: Charlie44333 folded before Flop (didn't bet)
Seat 3: professor190 folded before Flop (didn't bet)
Seat 4: BB_tape112 (button) folded before Flop (didn't bet)
Seat 5: Soranton (small blind) folded before Flop
Seat 6: Benzer586 (big blind) folded before Flop


*********** # 18 **************
PokerStars Hand #197158349152:  Hold'em No Limit ($0.01/$0.02 USD) - 2019/02/17 7:43:54 ET
Table 'Coppelia III' 6-max Seat #3 is the button
Seat 1: Ganseku Nagi ($2.83 in chips)
Seat 2: Charlie44333 ($2.34 in chips)
Seat 3: professor190 ($2 in chips)
Seat 4: BB_tape112 ($2.02 in chips)
Seat 5: Soranton ($2.99 in chips)
Seat 6: Benzer586 ($1.88 in chips)
BB_tape112: posts small blind $0.01
Soranton: posts big blind $0.02
*** HOLE CARDS ***
Dealt to Benzer586 [Jd 4c]
Benzer586: folds
Ganseku Nagi: folds
Charlie44333: folds
professor190: folds
BB_tape112: raises $0.04 to $0.06
Soranton: folds
Uncalled bet ($0.04) returned to BB_tape112
BB_tape112 collected $0.04 from pot
BB_tape112: doesn't show hand
*** SUMMARY ***
Total pot $0.04 | Rake $0
Seat 1: Ganseku Nagi folded before Flop (didn't bet)
Seat 2: Charlie44333 folded before Flop (didn't bet)
Seat 3: professor190 (button) folded before Flop (didn't bet)
Seat 4: BB_tape112 (small blind) collected ($0.04)
Seat 5: Soranton (big blind) folded before Flop
Seat 6: Benzer586 folded before Flop (didn't bet)


*********** # 19 **************
PokerStars Hand #197158329703:  Hold'em No Limit ($0.01/$0.02 USD) - 2019/02/17 7:43:13 ET
Table 'Coppelia III' 6-max Seat #2 is the button
Seat 1: Ganseku Nagi ($2.67 in chips)
Seat 2: Charlie44333 ($2.34 in chips)
Seat 3: professor190 ($2 in chips)
Seat 4: BB_tape112 ($2.04 in chips)
Seat 5: Soranton ($2.99 in chips)
Seat 6: Benzer586 ($1.88 in chips)
professor190: posts small blind $0.01
BB_tape112: posts big blind $0.02
*** HOLE CARDS ***
Dealt to Benzer586 [5c 2d]
Soranton: folds
Benzer586: folds
Ganseku Nagi: raises $0.04 to $0.06
Charlie44333: folds
professor190: calls $0.05
BB_tape112: folds
*** FLOP *** [4c 5h 7s]
professor190: bets $0.09
Ganseku Nagi: raises $0.16 to $0.25
professor190: folds
Uncalled bet ($0.16) returned to Ganseku Nagi
Ganseku Nagi collected $0.31 from pot
Ganseku Nagi: doesn't show hand
*** SUMMARY ***
Total pot $0.32 | Rake $0.01
Board [4c 5h 7s]
Seat 1: Ganseku Nagi collected ($0.31)
Seat 2: Charlie44333 (button) folded before Flop (didn't bet)
Seat 3: professor190 (small blind) folded on the Flop
Seat 4: BB_tape112 (big blind) folded before Flop
Seat 5: Soranton folded before Flop (didn't bet)
Seat 6: Benzer586 folded before Flop (didn't bet)


*********** # 20 **************
PokerStars Hand #197158323238:  Hold'em No Limit ($0.01/$0.02 USD) - 2019/02/17 7:43:00 ET
Table 'Coppelia III' 6-max Seat #1 is the button
Seat 1: Ganseku Nagi ($2.64 in chips)
Seat 2: Charlie44333 ($2.35 in chips)
Seat 3: professor190 ($2 in chips)
Seat 4: BB_tape112 ($2.04 in chips)
Seat 5: Soranton ($2.99 in chips)
Seat 6: Benzer586 ($1.88 in chips)
Charlie44333: posts small blind $0.01
professor190: posts big blind $0.02
*** HOLE CARDS ***
Dealt to Benzer586 [Ts 2s]
BB_tape112: folds
Soranton: folds
Benzer586: folds
Ganseku Nagi: raises $0.02 to $0.04
Charlie44333: folds
professor190: folds
Uncalled bet ($0.02) returned to Ganseku Nagi
Ganseku Nagi collected $0.05 from pot
Ganseku Nagi: doesn't show hand
*** SUMMARY ***
Total pot $0.05 | Rake $0
Seat 1: Ganseku Nagi (button) collected ($0.05)
Seat 2: Charlie44333 (small blind) folded before Flop
Seat 3: professor190 (big blind) folded before Flop
Seat 4: BB_tape112 folded before Flop (didn't bet)
Seat 5: Soranton folded before Flop (didn't bet)
Seat 6: Benzer586 folded before Flop (didn't bet)


*********** # 21 **************
PokerStars Hand #197158297287:  Hold'em No Limit ($0.01/$0.02 USD) - 2019/02/17 7:42:06 ET
Table 'Coppelia III' 6-max Seat #6 is the button
Seat 1: Ganseku Nagi ($3.02 in chips)
Seat 2: Charlie44333 ($2 in chips)
Seat 4: BB_tape112 ($2.04 in chips)
Seat 5: Soranton ($2.99 in chips)
Seat 6: Benzer586 ($1.88 in chips)
Ganseku Nagi: posts small blind $0.01
Charlie44333: posts big blind $0.02
*** HOLE CARDS ***
Dealt to Benzer586 [Th 6c]
professor190 joins the table at seat #3
BB_tape112: folds
Soranton: folds
Benzer586: folds
Ganseku Nagi: raises $0.04 to $0.06
Charlie44333: raises $0.12 to $0.18
Ganseku Nagi: calls $0.12
*** FLOP *** [Kd 5c 7d]
Ganseku Nagi: checks
Charlie44333: checks
*** TURN *** [Kd 5c 7d] [Ac]
Ganseku Nagi: bets $0.20
Charlie44333: calls $0.20
*** RIVER *** [Kd 5c 7d Ac] [3s]
Ganseku Nagi: checks
Charlie44333: checks
*** SHOW DOWN ***
Ganseku Nagi: shows [2s 2c] (a pair of Deuces)
Charlie44333: shows [Ah Jh] (a pair of Aces)
Charlie44333 collected $0.73 from pot
*** SUMMARY ***
Total pot $0.76 | Rake $0.03
Board [Kd 5c 7d Ac 3s]
Seat 1: Ganseku Nagi (small blind) showed [2s 2c] and lost with a pair of Deuces
Seat 2: Charlie44333 (big blind) showed [Ah Jh] and won ($0.73) with a pair of Aces
Seat 4: BB_tape112 folded before Flop (didn't bet)
Seat 5: Soranton folded before Flop (didn't bet)
Seat 6: Benzer586 (button) folded before Flop (didn't bet)


*********** # 22 **************
PokerStars Hand #197158287381:  Hold'em No Limit ($0.01/$0.02 USD) - 2019/02/17 7:41:45 ET
Table 'Coppelia III' 6-max Seat #5 is the button
Seat 1: Ganseku Nagi ($3.06 in chips)
Seat 2: Charlie44333 ($2 in chips)
Seat 4: BB_tape112 ($2.04 in chips)
Seat 5: Soranton ($2.99 in chips)
Seat 6: Benzer586 ($1.84 in chips)
Benzer586: posts small blind $0.01
Ganseku Nagi: posts big blind $0.02
*** HOLE CARDS ***
Dealt to Benzer586 [Kc 8c]
Charlie44333: folds
BB_tape112: folds
Soranton: folds
Benzer586: raises $0.02 to $0.04
Ganseku Nagi: calls $0.02
*** FLOP *** [5c Qc 3c]
Benzer586: bets $0.14
Ganseku Nagi: folds
Uncalled bet ($0.14) returned to Benzer586
Benzer586 collected $0.08 from pot
Benzer586: doesn't show hand
*** SUMMARY ***
Total pot $0.08 | Rake $0
Board [5c Qc 3c]
Seat 1: Ganseku Nagi (big blind) folded on the Flop
Seat 2: Charlie44333 folded before Flop (didn't bet)
Seat 4: BB_tape112 folded before Flop (didn't bet)
Seat 5: Soranton (button) folded before Flop (didn't bet)
Seat 6: Benzer586 (small blind) collected ($0.08)


*********** # 23 **************
PokerStars Hand #197158274295:  Hold'em No Limit ($0.01/$0.02 USD) - 2019/02/17 7:41:17 ET
Table 'Coppelia III' 6-max Seat #4 is the button
Seat 1: Ganseku Nagi ($3.06 in chips)
Seat 2: Charlie44333 ($2 in chips)
Seat 4: BB_tape112 ($2.04 in chips)
Seat 5: Soranton ($3 in chips)
Seat 6: Benzer586 ($1.83 in chips)
Soranton: posts small blind $0.01
Benzer586: posts big blind $0.02
*** HOLE CARDS ***
Dealt to Benzer586 [2d Ts]
Ganseku Nagi: folds
Charlie44333: folds
BB_tape112 has timed out
BB_tape112: folds
Soranton: folds
Uncalled bet ($0.01) returned to Benzer586
Benzer586 collected $0.02 from pot
Benzer586: doesn't show hand
*** SUMMARY ***
Total pot $0.02 | Rake $0
Seat 1: Ganseku Nagi folded before Flop (didn't bet)
Seat 2: Charlie44333 folded before Flop (didn't bet)
Seat 4: BB_tape112 (button) folded before Flop (didn't bet)
Seat 5: Soranton (small blind) folded before Flop
Seat 6: Benzer586 (big blind) collected ($0.02)


*********** # 24 **************
PokerStars Hand #197158261264:  Hold'em No Limit ($0.01/$0.02 USD) - 2019/02/17 7:40:50 ET
Table 'Coppelia III' 6-max Seat #3 is the button
Seat 1: Ganseku Nagi ($2.99 in chips)
Seat 2: Charlie44333 ($2 in chips)
Seat 3: Maksim538 ($2.14 in chips)
Seat 4: BB_tape112 ($2.05 in chips)
Seat 5: Soranton ($3.06 in chips)
Seat 6: Benzer586 ($1.83 in chips)
BB_tape112: posts small blind $0.01
Soranton: posts big blind $0.02
*** HOLE CARDS ***
Dealt to Benzer586 [Tc 5c]
Benzer586: folds
Ganseku Nagi: raises $0.04 to $0.06
Charlie44333: folds
Maksim538: folds
Maksim538 leaves the table
BB_tape112: folds
Soranton: calls $0.04
*** FLOP *** [9s 7s Qh]
Soranton: checks
Ganseku Nagi: checks
*** TURN *** [9s 7s Qh] [Ks]
Soranton: checks
Ganseku Nagi: bets $0.08
Soranton: folds
Uncalled bet ($0.08) returned to Ganseku Nagi
Ganseku Nagi collected $0.13 from pot
Ganseku Nagi: doesn't show hand
*** SUMMARY ***
Total pot $0.13 | Rake $0
Board [9s 7s Qh Ks]
Seat 1: Ganseku Nagi collected ($0.13)
Seat 2: Charlie44333 folded before Flop (didn't bet)
Seat 3: Maksim538 (button) folded before Flop (didn't bet)
Seat 4: BB_tape112 (small blind) folded before Flop
Seat 5: Soranton (big blind) folded on the Turn
Seat 6: Benzer586 folded before Flop (didn't bet)


*********** # 25 **************
PokerStars Hand #197158238842:  Hold'em No Limit ($0.01/$0.02 USD) - 2019/02/17 7:40:03 ET
Table 'Coppelia III' 6-max Seat #2 is the button
Seat 1: Ganseku Nagi ($2.99 in chips)
Seat 2: Charlie44333 ($2 in chips)
Seat 3: Maksim538 ($2.16 in chips)
Seat 4: BB_tape112 ($2.03 in chips)
Seat 5: Soranton ($3.06 in chips)
Seat 6: Benzer586 ($1.83 in chips)
Maksim538: posts small blind $0.01
BB_tape112: posts big blind $0.02
*** HOLE CARDS ***
Dealt to Benzer586 [3d Tc]
Soranton: folds
Benzer586: folds
Ganseku Nagi: folds
Charlie44333: folds
Maksim538: calls $0.01
BB_tape112: checks
*** FLOP *** [Jd 8c 4d]
Maksim538: checks
BB_tape112: bets $0.02
Maksim538: folds
Uncalled bet ($0.02) returned to BB_tape112
BB_tape112 collected $0.04 from pot
BB_tape112: doesn't show hand
*** SUMMARY ***
Total pot $0.04 | Rake $0
Board [Jd 8c 4d]
Seat 1: Ganseku Nagi folded before Flop (didn't bet)
Seat 2: Charlie44333 (button) folded before Flop (didn't bet)
Seat 3: Maksim538 (small blind) folded on the Flop
Seat 4: BB_tape112 (big blind) collected ($0.04)
Seat 5: Soranton folded before Flop (didn't bet)
Seat 6: Benzer586 folded before Flop (didn't bet)


*********** # 26 **************
PokerStars Hand #197158221318:  Hold'em No Limit ($0.01/$0.02 USD) - 2019/02/17 7:39:26 ET
Table 'Coppelia III' 6-max Seat #1 is the button
Seat 1: Ganseku Nagi ($2.99 in chips)
Seat 2: Charlie44333 ($2 in chips)
Seat 3: Maksim538 ($2.15 in chips)
Seat 4: BB_tape112 ($2.03 in chips)
Seat 5: Soranton ($3.06 in chips)
Seat 6: Benzer586 ($1.83 in chips)
Charlie44333: posts small blind $0.01
Maksim538: posts big blind $0.02
*** HOLE CARDS ***
Dealt to Benzer586 [7h 9h]
BB_tape112: folds
Soranton: folds
Benzer586: folds
Ganseku Nagi: raises $0.02 to $0.04
Charlie44333: folds
Maksim538: calls $0.02
*** FLOP *** [As Ts Td]
Maksim538: checks
Ganseku Nagi: checks
*** TURN *** [As Ts Td] [8h]
Maksim538: checks
Ganseku Nagi: checks
*** RIVER *** [As Ts Td 8h] [8c]
Maksim538: checks
Ganseku Nagi: checks
*** SHOW DOWN ***
Maksim538: shows [Jc 6d] (two pair, Tens and Eights)
Ganseku Nagi: shows [3h 4h] (two pair, Tens and Eights)
Maksim538 collected $0.05 from pot
Ganseku Nagi collected $0.04 from pot
*** SUMMARY ***
Total pot $0.09 | Rake $0
Board [As Ts Td 8h 8c]
Seat 1: Ganseku Nagi (button) showed [3h 4h] and won ($0.04) with two pair, Tens and Eights
Seat 2: Charlie44333 (small blind) folded before Flop
Seat 3: Maksim538 (big blind) showed [Jc 6d] and won ($0.05) with two pair, Tens and Eights
Seat 4: BB_tape112 folded before Flop (didn't bet)
Seat 5: Soranton folded before Flop (didn't bet)
Seat 6: Benzer586 folded before Flop (didn't bet)


*********** # 27 **************
PokerStars Hand #197158211429:  Hold'em No Limit ($0.01/$0.02 USD) - 2019/02/17 7:39:04 ET
Table 'Coppelia III' 6-max Seat #6 is the button
Seat 1: Ganseku Nagi ($3.09 in chips)
Seat 2: Charlie44333 ($2 in chips)
Seat 3: Maksim538 ($1.94 in chips)
Seat 4: BB_tape112 ($2.03 in chips)
Seat 5: Soranton ($3.16 in chips)
Seat 6: Benzer586 ($1.83 in chips)
Ganseku Nagi: posts small blind $0.01
Charlie44333: posts big blind $0.02
*** HOLE CARDS ***
Dealt to Benzer586 [2c 3h]
Maksim538: calls $0.02
BB_tape112: folds
Soranton: raises $0.08 to $0.10
Benzer586: folds
Ganseku Nagi: calls $0.09
Charlie44333: folds
Maksim538: calls $0.08
*** FLOP *** [Kc Jd Ad]
Ganseku Nagi: checks
Maksim538: bets $0.30
Soranton: folds
Ganseku Nagi: folds
Uncalled bet ($0.30) returned to Maksim538
Maksim538 collected $0.31 from pot
Maksim538: doesn't show hand
*** SUMMARY ***
Total pot $0.32 | Rake $0.01
Board [Kc Jd Ad]
Seat 1: Ganseku Nagi (small blind) folded on the Flop
Seat 2: Charlie44333 (big blind) folded before Flop
Seat 3: Maksim538 collected ($0.31)
Seat 4: BB_tape112 folded before Flop (didn't bet)
Seat 5: Soranton folded on the Flop
Seat 6: Benzer586 (button) folded before Flop (didn't bet)


*********** # 28 **************
PokerStars Hand #197158205373:  Hold'em No Limit ($0.01/$0.02 USD) - 2019/02/17 7:38:52 ET
Table 'Coppelia III' 6-max Seat #5 is the button
Seat 1: Ganseku Nagi ($3.11 in chips)
Seat 2: Charlie44333 ($2 in chips)
Seat 3: Maksim538 ($1.94 in chips)
Seat 4: BB_tape112 ($2 in chips)
Seat 5: Soranton ($3.16 in chips)
Seat 6: Benzer586 ($1.84 in chips)
Benzer586: posts small blind $0.01
Ganseku Nagi: posts big blind $0.02
*** HOLE CARDS ***
Dealt to Benzer586 [3h Jc]
Charlie44333: folds
Maksim538: folds
BB_tape112: raises $0.03 to $0.05
Soranton: folds
Benzer586: folds
Ganseku Nagi: folds
Uncalled bet ($0.03) returned to BB_tape112
BB_tape112 collected $0.05 from pot
*** SUMMARY ***
Total pot $0.05 | Rake $0
Seat 1: Ganseku Nagi (big blind) folded before Flop
Seat 2: Charlie44333 folded before Flop (didn't bet)
Seat 3: Maksim538 folded before Flop (didn't bet)
Seat 4: BB_tape112 collected ($0.05)
Seat 5: Soranton (button) folded before Flop (didn't bet)
Seat 6: Benzer586 (small blind) folded before Flop


*********** # 29 **************
PokerStars Hand #197158163535:  Hold'em No Limit ($0.01/$0.02 USD) - 2019/02/17 7:37:24 ET
Table 'Coppelia III' 6-max Seat #4 is the button
Seat 1: Ganseku Nagi ($2.61 in chips)
Seat 2: Charlie44333 ($2.03 in chips)
Seat 3: Maksim538 ($1.94 in chips)
Seat 4: BB_tape112 ($2 in chips)
Seat 5: Soranton ($3.17 in chips)
Seat 6: Benzer586 ($1.86 in chips)
Soranton: posts small blind $0.01
Benzer586: posts big blind $0.02
*** HOLE CARDS ***
Dealt to Benzer586 [4s 2c]
Ganseku Nagi: raises $0.04 to $0.06
Charlie44333: raises $0.15 to $0.21
Maksim538: folds
BB_tape112: folds
Soranton: folds
Benzer586: folds
Ganseku Nagi: calls $0.15
*** FLOP *** [5c 8h 7s]
Ganseku Nagi: checks
Charlie44333: checks
*** TURN *** [5c 8h 7s] [5s]
Ganseku Nagi: bets $0.30
Charlie44333: calls $0.30
*** RIVER *** [5c 8h 7s 5s] [6s]
Ganseku Nagi: bets $0.50
Charlie44333: folds
Uncalled bet ($0.50) returned to Ganseku Nagi
Ganseku Nagi collected $1.01 from pot
Ganseku Nagi: doesn't show hand
*** SUMMARY ***
Total pot $1.05 | Rake $0.04
Board [5c 8h 7s 5s 6s]
Seat 1: Ganseku Nagi collected ($1.01)
Seat 2: Charlie44333 folded on the River
Seat 3: Maksim538 folded before Flop (didn't bet)
Seat 4: BB_tape112 (button) folded before Flop (didn't bet)
Seat 5: Soranton (small blind) folded before Flop
Seat 6: Benzer586 (big blind) folded before Flop


*********** # 30 **************
PokerStars Hand #197158140322:  Hold'em No Limit ($0.01/$0.02 USD) - 2019/02/17 7:36:35 ET
Table 'Coppelia III' 6-max Seat #3 is the button
Seat 1: Ganseku Nagi ($2.91 in chips)
Seat 2: Charlie44333 ($2.03 in chips)
Seat 3: Maksim538 ($1.58 in chips)
Seat 4: BB_tape112 ($2 in chips)
Seat 5: Soranton ($3.19 in chips)
Seat 6: Benzer586 ($1.86 in chips)
BB_tape112: posts small blind $0.01
Soranton: posts big blind $0.02
*** HOLE CARDS ***
Dealt to Benzer586 [2h 3s]
Benzer586: folds
Ganseku Nagi: raises $0.04 to $0.06
Charlie44333: folds
Maksim538: calls $0.06
BB_tape112: calls $0.05
Soranton: folds
*** FLOP *** [6d 5d Kc]
BB_tape112: checks
Ganseku Nagi: bets $0.12
Maksim538: raises $0.12 to $0.24
BB_tape112: folds
Ganseku Nagi: calls $0.12
*** TURN *** [6d 5d Kc] [Th]
Ganseku Nagi: checks
Maksim538: bets $0.66
Ganseku Nagi: folds
Uncalled bet ($0.66) returned to Maksim538
Maksim538 collected $0.66 from pot
Maksim538: doesn't show hand
*** SUMMARY ***
Total pot $0.68 | Rake $0.02
Board [6d 5d Kc Th]
Seat 1: Ganseku Nagi folded on the Turn
Seat 2: Charlie44333 folded before Flop (didn't bet)
Seat 3: Maksim538 (button) collected ($0.66)
Seat 4: BB_tape112 (small blind) folded on the Flop
Seat 5: Soranton (big blind) folded before Flop
Seat 6: Benzer586 folded before Flop (didn't bet)


*********** # 31 **************
PokerStars Hand #197158128622:  Hold'em No Limit ($0.01/$0.02 USD) - 2019/02/17 7:36:11 ET
Table 'Coppelia III' 6-max Seat #2 is the button
Seat 1: Ganseku Nagi ($2.91 in chips)
Seat 2: Charlie44333 ($2 in chips)
Seat 3: Maksim538 ($1.59 in chips)
Seat 4: BB_tape112 ($2.01 in chips)
Seat 5: Soranton ($3.19 in chips)
Seat 6: Benzer586 ($1.86 in chips)
Maksim538: posts small blind $0.01
BB_tape112: posts big blind $0.02
*** HOLE CARDS ***
Dealt to Benzer586 [9c Qh]
Soranton: folds
Benzer586: folds
Ganseku Nagi: folds
Charlie44333: raises $0.03 to $0.05
Maksim538: folds
BB_tape112: folds
Uncalled bet ($0.03) returned to Charlie44333
Charlie44333 collected $0.05 from pot
Charlie44333: doesn't show hand
*** SUMMARY ***
Total pot $0.05 | Rake $0
Seat 1: Ganseku Nagi folded before Flop (didn't bet)
Seat 2: Charlie44333 (button) collected ($0.05)
Seat 3: Maksim538 (small blind) folded before Flop
Seat 4: BB_tape112 (big blind) folded before Flop
Seat 5: Soranton folded before Flop (didn't bet)
Seat 6: Benzer586 folded before Flop (didn't bet)


*********** # 32 **************
PokerStars Hand #197158096633:  Hold'em No Limit ($0.01/$0.02 USD) - 2019/02/17 7:35:03 ET
Table 'Coppelia III' 6-max Seat #1 is the button
Seat 1: Ganseku Nagi ($2.95 in chips)
Seat 2: Charlie44333 ($2 in chips)
Seat 3: Maksim538 ($1.54 in chips)
Seat 4: BB_tape112 ($2.01 in chips)
Seat 5: Soranton ($3.19 in chips)
Seat 6: Benzer586 ($1.86 in chips)
Charlie44333: posts small blind $0.01
Maksim538: posts big blind $0.02
*** HOLE CARDS ***
Dealt to Benzer586 [7s 4d]
BB_tape112: folds
Soranton has timed out
Soranton: folds
Benzer586: folds
Ganseku Nagi: raises $0.02 to $0.04
Charlie44333: folds
Maksim538: calls $0.02
*** FLOP *** [5d 5s 8h]
Maksim538: checks
Ganseku Nagi: checks
*** TURN *** [5d 5s 8h] [9d]
Maksim538: checks
Ganseku Nagi: checks
*** RIVER *** [5d 5s 8h 9d] [Qc]
Maksim538: checks
Ganseku Nagi: checks
*** SHOW DOWN ***
Maksim538: shows [Ad 4h] (a pair of Fives)
Ganseku Nagi: mucks hand
Maksim538 collected $0.09 from pot
*** SUMMARY ***
Total pot $0.09 | Rake $0
Board [5d 5s 8h 9d Qc]
Seat 1: Ganseku Nagi (button) mucked [6s Jh]
Seat 2: Charlie44333 (small blind) folded before Flop
Seat 3: Maksim538 (big blind) showed [Ad 4h] and won ($0.09) with a pair of Fives
Seat 4: BB_tape112 folded before Flop (didn't bet)
Seat 5: Soranton folded before Flop (didn't bet)
Seat 6: Benzer586 folded before Flop (didn't bet)


*********** # 33 **************
PokerStars Hand #197158079953:  Hold'em No Limit ($0.01/$0.02 USD) - 2019/02/17 7:34:27 ET
Table 'Coppelia III' 6-max Seat #6 is the button
Seat 1: Ganseku Nagi ($2.96 in chips)
Seat 2: Charlie44333 ($2 in chips)
Seat 3: Maksim538 ($1.37 in chips)
Seat 4: BB_tape112 ($2.16 in chips)
Seat 5: Soranton ($3.19 in chips)
Seat 6: Benzer586 ($1.86 in chips)
Ganseku Nagi: posts small blind $0.01
Charlie44333: posts big blind $0.02
*** HOLE CARDS ***
Dealt to Benzer586 [Js 8s]
Maksim538: calls $0.02
BB_tape112: raises $0.05 to $0.07
Soranton: folds
Benzer586: folds
Ganseku Nagi: folds
Charlie44333: folds
Maksim538: calls $0.05
*** FLOP *** [7h 9c 8h]
Maksim538: checks
BB_tape112: bets $0.08
Maksim538: calls $0.08
*** TURN *** [7h 9c 8h] [7s]
Maksim538: checks
BB_tape112: checks
*** RIVER *** [7h 9c 8h 7s] [4h]
Maksim538: bets $0.16
BB_tape112: folds
Uncalled bet ($0.16) returned to Maksim538
Maksim538 collected $0.32 from pot
Maksim538: doesn't show hand
*** SUMMARY ***
Total pot $0.33 | Rake $0.01
Board [7h 9c 8h 7s 4h]
Seat 1: Ganseku Nagi (small blind) folded before Flop
Seat 2: Charlie44333 (big blind) folded before Flop
Seat 3: Maksim538 collected ($0.32)
Seat 4: BB_tape112 folded on the River
Seat 5: Soranton folded before Flop (didn't bet)
Seat 6: Benzer586 (button) folded before Flop (didn't bet)


*********** # 34 **************
PokerStars Hand #197158065978:  Hold'em No Limit ($0.01/$0.02 USD) - 2019/02/17 7:33:57 ET
Table 'Coppelia III' 6-max Seat #5 is the button
Seat 1: Ganseku Nagi ($3.02 in chips)
Seat 3: Maksim538 ($1.43 in chips)
Seat 4: BB_tape112 ($2.04 in chips)
Seat 5: Soranton ($3.19 in chips)
Seat 6: Benzer586 ($1.87 in chips)
Benzer586: posts small blind $0.01
Ganseku Nagi: posts big blind $0.02
Charlie44333: sits out
*** HOLE CARDS ***
Dealt to Benzer586 [9d 6h]
Maksim538: calls $0.02
BB_tape112: raises $0.04 to $0.06
Soranton: folds
Benzer586: folds
Ganseku Nagi: calls $0.04
Maksim538: calls $0.04
*** FLOP *** [7c Ts 9c]
Ganseku Nagi: checks
Maksim538: checks
BB_tape112: bets $0.14
Ganseku Nagi: folds
Maksim538: folds
Uncalled bet ($0.14) returned to BB_tape112
BB_tape112 collected $0.18 from pot
BB_tape112: doesn't show hand
*** SUMMARY ***
Total pot $0.19 | Rake $0.01
Board [7c Ts 9c]
Seat 1: Ganseku Nagi (big blind) folded on the Flop
Seat 3: Maksim538 folded on the Flop
Seat 4: BB_tape112 collected ($0.18)
Seat 5: Soranton (button) folded before Flop (didn't bet)
Seat 6: Benzer586 (small blind) folded before Flop


*********** # 35 **************
PokerStars Hand #197158056979:  Hold'em No Limit ($0.01/$0.02 USD) - 2019/02/17 7:33:38 ET
Table 'Coppelia III' 6-max Seat #4 is the button
Seat 1: Ganseku Nagi ($3.02 in chips)
Seat 3: Maksim538 ($1.43 in chips)
Seat 4: BB_tape112 ($2.09 in chips)
Seat 5: Soranton ($3.12 in chips)
Seat 6: Benzer586 ($1.89 in chips)
Soranton: posts small blind $0.01
Benzer586: posts big blind $0.02
Charlie44333: sits out
*** HOLE CARDS ***
Dealt to Benzer586 [Ks 9h]
Ganseku Nagi: folds
Maksim538: folds
BB_tape112: raises $0.03 to $0.05
Soranton: raises $0.11 to $0.16
Benzer586: folds
BB_tape112: folds
Uncalled bet ($0.11) returned to Soranton
Soranton collected $0.12 from pot
Soranton: doesn't show hand
*** SUMMARY ***
Total pot $0.12 | Rake $0
Seat 1: Ganseku Nagi folded before Flop (didn't bet)
Seat 3: Maksim538 folded before Flop (didn't bet)
Seat 4: BB_tape112 (button) folded before Flop
Seat 5: Soranton (small blind) collected ($0.12)
Seat 6: Benzer586 (big blind) folded before Flop


*********** # 36 **************
PokerStars Hand #197158029717:  Hold'em No Limit ($0.01/$0.02 USD) - 2019/02/17 7:32:41 ET
Table 'Coppelia III' 6-max Seat #3 is the button
Seat 1: Ganseku Nagi ($3.02 in chips)
Seat 3: Maksim538 ($1.37 in chips)
Seat 4: BB_tape112 ($2.13 in chips)
Seat 5: Soranton ($3.14 in chips)
Seat 6: Benzer586 ($1.89 in chips)
BB_tape112: posts small blind $0.01
Soranton: posts big blind $0.02
*** HOLE CARDS ***
Dealt to Benzer586 [Td 3d]
Charlie44333 joins the table at seat #2
Benzer586: folds
Ganseku Nagi: folds
Maksim538: raises $0.02 to $0.04
BB_tape112: calls $0.03
Soranton: folds
*** FLOP *** [Ad 8d 2c]
BB_tape112: checks
Maksim538: bets $0.04
BB_tape112: folds
Uncalled bet ($0.04) returned to Maksim538
Maksim538 collected $0.10 from pot
Maksim538: doesn't show hand
*** SUMMARY ***
Total pot $0.10 | Rake $0
Board [Ad 8d 2c]
Seat 1: Ganseku Nagi folded before Flop (didn't bet)
Seat 3: Maksim538 (button) collected ($0.10)
Seat 4: BB_tape112 (small blind) folded on the Flop
Seat 5: Soranton (big blind) folded before Flop
Seat 6: Benzer586 folded before Flop (didn't bet)


*********** # 37 **************
PokerStars Hand #197158009734:  Hold'em No Limit ($0.01/$0.02 USD) - 2019/02/17 7:31:58 ET
Table 'Coppelia III' 6-max Seat #1 is the button
Seat 1: Ganseku Nagi ($2.92 in chips)
Seat 2: Kozin_S ($1.78 in chips)
Seat 3: Maksim538 ($1.42 in chips)
Seat 4: BB_tape112 ($2.18 in chips)
Seat 5: Soranton ($3.14 in chips)
Seat 6: Benzer586 ($1.89 in chips)
Kozin_S: posts small blind $0.01
Maksim538: posts big blind $0.02
*** HOLE CARDS ***
Dealt to Benzer586 [Ts 2d]
BB_tape112: raises $0.03 to $0.05
Soranton: folds
Benzer586: folds
Ganseku Nagi: calls $0.05
Kozin_S: folds
Maksim538: calls $0.03
*** FLOP *** [4c 7s Td]
Kozin_S leaves the table
Maksim538: checks
BB_tape112: checks
Ganseku Nagi: checks
*** TURN *** [4c 7s Td] [2h]
Maksim538: checks
BB_tape112: checks
Ganseku Nagi: checks
*** RIVER *** [4c 7s Td 2h] [Ks]
Maksim538: checks
BB_tape112: checks
Ganseku Nagi: checks
*** SHOW DOWN ***
Maksim538: shows [9h 5s] (high card King)
BB_tape112: shows [Qc Jc] (high card King - Queen kicker)
Ganseku Nagi: shows [5c As] (high card Ace)
Ganseku Nagi collected $0.15 from pot
*** SUMMARY ***
Total pot $0.16 | Rake $0.01
Board [4c 7s Td 2h Ks]
Seat 1: Ganseku Nagi (button) showed [5c As] and won ($0.15) with high card Ace
Seat 2: Kozin_S (small blind) folded before Flop
Seat 3: Maksim538 (big blind) showed [9h 5s] and lost with high card King
Seat 4: BB_tape112 showed [Qc Jc] and lost with high card King
Seat 5: Soranton folded before Flop (didn't bet)
Seat 6: Benzer586 folded before Flop (didn't bet)


*********** # 38 **************
PokerStars Hand #197157995858:  Hold'em No Limit ($0.01/$0.02 USD) - 2019/02/17 7:31:28 ET
Table 'Coppelia III' 6-max Seat #6 is the button
Seat 1: Ganseku Nagi ($3.28 in chips)
Seat 2: Kozin_S ($1.45 in chips)
Seat 3: Maksim538 ($1.42 in chips)
Seat 4: BB_tape112 ($2.18 in chips)
Seat 5: Soranton ($3.14 in chips)
Seat 6: Benzer586 ($1.89 in chips)
Ganseku Nagi: posts small blind $0.01
Kozin_S: posts big blind $0.02
*** HOLE CARDS ***
Dealt to Benzer586 [Ac 7d]
Maksim538: folds
BB_tape112: folds
Soranton: folds
Benzer586: folds
Ganseku Nagi: raises $0.04 to $0.06
Kozin_S: calls $0.04
*** FLOP *** [8c 4h 5h]
Ganseku Nagi: bets $0.10
Kozin_S: calls $0.10
*** TURN *** [8c 4h 5h] [7s]
Ganseku Nagi: bets $0.20
Kozin_S: calls $0.20
*** RIVER *** [8c 4h 5h 7s] [Qh]
Ganseku Nagi: checks
Kozin_S: checks
*** SHOW DOWN ***
Ganseku Nagi: shows [Kc Kh] (a pair of Kings)
Kozin_S: shows [As 6c] (a straight, Four to Eight)
Kozin_S collected $0.69 from pot
*** SUMMARY ***
Total pot $0.72 | Rake $0.03
Board [8c 4h 5h 7s Qh]
Seat 1: Ganseku Nagi (small blind) showed [Kc Kh] and lost with a pair of Kings
Seat 2: Kozin_S (big blind) showed [As 6c] and won ($0.69) with a straight, Four to Eight
Seat 3: Maksim538 folded before Flop (didn't bet)
Seat 4: BB_tape112 folded before Flop (didn't bet)
Seat 5: Soranton folded before Flop (didn't bet)
Seat 6: Benzer586 (button) folded before Flop (didn't bet)


*********** # 39 **************
PokerStars Hand #197157983174:  Hold'em No Limit ($0.01/$0.02 USD) - 2019/02/17 7:31:01 ET
Table 'Coppelia III' 6-max Seat #5 is the button
Seat 1: Ganseku Nagi ($3.30 in chips)
Seat 2: Kozin_S ($1.56 in chips)
Seat 3: Maksim538 ($1.53 in chips)
Seat 4: BB_tape112 ($2.18 in chips)
Seat 5: Soranton ($2.90 in chips)
Seat 6: Benzer586 ($1.90 in chips)
Benzer586: posts small blind $0.01
Ganseku Nagi: posts big blind $0.02
Kozin_S: posts big blind $0.02
*** HOLE CARDS ***
Dealt to Benzer586 [As 6h]
Kozin_S: checks
Maksim538: calls $0.02
BB_tape112: folds
Soranton: raises $0.09 to $0.11
Benzer586: folds
Ganseku Nagi: folds
Kozin_S: calls $0.09
Maksim538: calls $0.09
*** FLOP *** [2s Kh Kc]
Kozin_S: checks
Maksim538: checks
Soranton: bets $0.18
Kozin_S: folds
Maksim538: folds
Uncalled bet ($0.18) returned to Soranton
Soranton collected $0.35 from pot
Soranton: doesn't show hand
*** SUMMARY ***
Total pot $0.36 | Rake $0.01
Board [2s Kh Kc]
Seat 1: Ganseku Nagi (big blind) folded before Flop
Seat 2: Kozin_S folded on the Flop
Seat 3: Maksim538 folded on the Flop
Seat 4: BB_tape112 folded before Flop (didn't bet)
Seat 5: Soranton (button) collected ($0.35)
Seat 6: Benzer586 (small blind) folded before Flop


*********** # 40 **************
PokerStars Hand #197157973578:  Hold'em No Limit ($0.01/$0.02 USD) - 2019/02/17 7:30:40 ET
Table 'Coppelia III' 6-max Seat #4 is the button
Seat 1: Ganseku Nagi ($3.30 in chips)
Seat 3: Maksim538 ($1.60 in chips)
Seat 4: BB_tape112 ($2.09 in chips)
Seat 5: Soranton ($2.91 in chips)
Seat 6: Benzer586 ($1.92 in chips)
Soranton: posts small blind $0.01
Benzer586: posts big blind $0.02
*** HOLE CARDS ***
Dealt to Benzer586 [4h Kd]
Ganseku Nagi: folds
Maksim538: calls $0.02
Kozin_S joins the table at seat #2
BB_tape112: raises $0.05 to $0.07
Soranton: folds
Benzer586: folds
Maksim538: calls $0.05
*** FLOP *** [3h 5s Td]
Maksim538: checks
BB_tape112: bets $0.06
Maksim538: folds
Uncalled bet ($0.06) returned to BB_tape112
BB_tape112 collected $0.16 from pot
BB_tape112: doesn't show hand
*** SUMMARY ***
Total pot $0.17 | Rake $0.01
Board [3h 5s Td]
Seat 1: Ganseku Nagi folded before Flop (didn't bet)
Seat 3: Maksim538 folded on the Flop
Seat 4: BB_tape112 (button) collected ($0.16)
Seat 5: Soranton (small blind) folded before Flop
Seat 6: Benzer586 (big blind) folded before Flop


*********** # 41 **************
PokerStars Hand #197157966245:  Hold'em No Limit ($0.01/$0.02 USD) - 2019/02/17 7:30:24 ET
Table 'Coppelia III' 6-max Seat #3 is the button
Seat 1: Ganseku Nagi ($3.30 in chips)
Seat 3: Maksim538 ($1.62 in chips)
Seat 4: BB_tape112 ($2.10 in chips)
Seat 5: Soranton ($2.88 in chips)
Seat 6: Benzer586 ($1.92 in chips)
BB_tape112: posts small blind $0.01
Soranton: posts big blind $0.02
*** HOLE CARDS ***
Dealt to Benzer586 [Td 2h]
Benzer586: folds
Ganseku Nagi: folds
Maksim538: calls $0.02
BB_tape112: folds
Soranton: checks
*** FLOP *** [3h 7h 4d]
Soranton: bets $0.05
Maksim538: folds
Uncalled bet ($0.05) returned to Soranton
Soranton collected $0.05 from pot
Soranton: doesn't show hand
*** SUMMARY ***
Total pot $0.05 | Rake $0
Board [3h 7h 4d]
Seat 1: Ganseku Nagi folded before Flop (didn't bet)
Seat 3: Maksim538 (button) folded on the Flop
Seat 4: BB_tape112 (small blind) folded before Flop
Seat 5: Soranton (big blind) collected ($0.05)
Seat 6: Benzer586 folded before Flop (didn't bet)


*********** # 42 **************
PokerStars Hand #197157937328:  Hold'em No Limit ($0.01/$0.02 USD) - 2019/02/17 7:29:22 ET
Table 'Coppelia III' 6-max Seat #1 is the button
Seat 1: Ganseku Nagi ($4.12 in chips)
Seat 3: Maksim538 ($0.82 in chips)
Seat 4: BB_tape112 ($2.14 in chips)
Seat 5: Soranton ($2.88 in chips)
Seat 6: Benzer586 ($1.92 in chips)
Maksim538: posts small blind $0.01
BB_tape112: posts big blind $0.02
*** HOLE CARDS ***
Dealt to Benzer586 [Kh Ts]
Soranton: folds
Benzer586: folds
Ganseku Nagi: raises $0.02 to $0.04
Maksim538: calls $0.03
BB_tape112: calls $0.02
*** FLOP *** [9h 3h 8c]
Maksim538: bets $0.12
BB_tape112: folds
Ganseku Nagi: calls $0.12
*** TURN *** [9h 3h 8c] [5s]
Maksim538: bets $0.34
Ganseku Nagi: raises $1.03 to $1.37
Maksim538: calls $0.32 and is all-in
Uncalled bet ($0.71) returned to Ganseku Nagi
*** RIVER *** [9h 3h 8c 5s] [7h]
*** SHOW DOWN ***
Maksim538: shows [3d 9d] (two pair, Nines and Threes)
Ganseku Nagi: shows [9s As] (a pair of Nines)
Maksim538 collected $1.62 from pot
*** SUMMARY ***
Total pot $1.68 | Rake $0.06
Board [9h 3h 8c 5s 7h]
Seat 1: Ganseku Nagi (button) showed [9s As] and lost with a pair of Nines
Seat 3: Maksim538 (small blind) showed [3d 9d] and won ($1.62) with two pair, Nines and Threes
Seat 4: BB_tape112 (big blind) folded on the Flop
Seat 5: Soranton folded before Flop (didn't bet)
Seat 6: Benzer586 folded before Flop (didn't bet)


*********** # 43 **************
PokerStars Hand #197157932896:  Hold'em No Limit ($0.01/$0.02 USD) - 2019/02/17 7:29:13 ET
Table 'Coppelia III' 6-max Seat #6 is the button
Seat 1: Ganseku Nagi ($4.13 in chips)
Seat 3: Maksim538 ($0.81 in chips)
Seat 4: BB_tape112 ($2.14 in chips)
Seat 5: Soranton ($2.88 in chips)
Seat 6: Benzer586 ($1.92 in chips)
Ganseku Nagi: posts small blind $0.01
Maksim538: posts big blind $0.02
*** HOLE CARDS ***
Dealt to Benzer586 [7c Tc]
BB_tape112: folds
Soranton: folds
Benzer586: folds
Ganseku Nagi: folds
Uncalled bet ($0.01) returned to Maksim538
Maksim538 collected $0.02 from pot
Maksim538: doesn't show hand
*** SUMMARY ***
Total pot $0.02 | Rake $0
Seat 1: Ganseku Nagi (small blind) folded before Flop
Seat 3: Maksim538 (big blind) collected ($0.02)
Seat 4: BB_tape112 folded before Flop (didn't bet)
Seat 5: Soranton folded before Flop (didn't bet)
Seat 6: Benzer586 (button) folded before Flop (didn't bet)


*********** # 44 **************
PokerStars Hand #197157924653:  Hold'em No Limit ($0.01/$0.02 USD) - 2019/02/17 7:28:55 ET
Table 'Coppelia III' 6-max Seat #5 is the button
Seat 1: Ganseku Nagi ($4.15 in chips)
Seat 2: sibir555 ($2.87 in chips)
Seat 3: Maksim538 ($0.78 in chips)
Seat 4: BB_tape112 ($2.14 in chips)
Seat 5: Soranton ($2.88 in chips)
Seat 6: Benzer586 ($1.93 in chips)
Benzer586: posts small blind $0.01
Ganseku Nagi: posts big blind $0.02
*** HOLE CARDS ***
Dealt to Benzer586 [Ts 3h]
sibir555: folds
Maksim538: calls $0.02
BB_tape112: folds
sibir555 leaves the table
Soranton: folds
Benzer586: folds
Ganseku Nagi: checks
*** FLOP *** [Ks Qs 4s]
Ganseku Nagi: checks
Maksim538: bets $0.02
Ganseku Nagi: folds
Uncalled bet ($0.02) returned to Maksim538
Maksim538 collected $0.05 from pot
Maksim538: doesn't show hand
*** SUMMARY ***
Total pot $0.05 | Rake $0
Board [Ks Qs 4s]
Seat 1: Ganseku Nagi (big blind) folded on the Flop
Seat 2: sibir555 folded before Flop (didn't bet)
Seat 3: Maksim538 collected ($0.05)
Seat 4: BB_tape112 folded before Flop (didn't bet)
Seat 5: Soranton (button) folded before Flop (didn't bet)
Seat 6: Benzer586 (small blind) folded before Flop


*********** # 45 **************
PokerStars Hand #197157913433:  Hold'em No Limit ($0.01/$0.02 USD) - 2019/02/17 7:28:31 ET
Table 'Coppelia III' 6-max Seat #4 is the button
Seat 1: Ganseku Nagi ($4.15 in chips)
Seat 2: sibir555 ($2.87 in chips)
Seat 3: Maksim538 ($0.80 in chips)
Seat 4: BB_tape112 ($2.14 in chips)
Seat 5: Soranton ($2.90 in chips)
Seat 6: Benzer586 ($1.89 in chips)
Soranton: posts small blind $0.01
Benzer586: posts big blind $0.02
Maksim538: posts big blind $0.02
*** HOLE CARDS ***
Dealt to Benzer586 [Js Jc]
Ganseku Nagi: folds
sibir555: folds
Maksim538: checks
BB_tape112: folds
Soranton: calls $0.01
Benzer586: raises $0.08 to $0.10
Maksim538: folds
Soranton: folds
Uncalled bet ($0.08) returned to Benzer586
Benzer586 collected $0.06 from pot
Benzer586: doesn't show hand
*** SUMMARY ***
Total pot $0.06 | Rake $0
Seat 1: Ganseku Nagi folded before Flop (didn't bet)
Seat 2: sibir555 folded before Flop (didn't bet)
Seat 3: Maksim538 folded before Flop (didn't bet)
Seat 4: BB_tape112 (button) folded before Flop (didn't bet)
Seat 5: Soranton (small blind) folded before Flop
Seat 6: Benzer586 (big blind) collected ($0.06)


*********** # 46 **************
PokerStars Hand #197157891432:  Hold'em No Limit ($0.01/$0.02 USD) - 2019/02/17 7:27:44 ET
Table 'Coppelia III' 6-max Seat #2 is the button
Seat 1: Ganseku Nagi ($4.15 in chips)
Seat 2: sibir555 ($2.91 in chips)
Seat 4: BB_tape112 ($2.08 in chips)
Seat 5: Soranton ($2.92 in chips)
Seat 6: Benzer586 ($1.89 in chips)
Maksim538 will be allowed to play after the button
BB_tape112: posts small blind $0.01
Soranton: posts big blind $0.02
*** HOLE CARDS ***
Dealt to Benzer586 [6c Jd]
Benzer586: folds
Ganseku Nagi: folds
sibir555: raises $0.02 to $0.04
BB_tape112: calls $0.03
Soranton: folds
*** FLOP *** [4s 7c Th]
BB_tape112: checks
sibir555: checks
*** TURN *** [4s 7c Th] [Ks]
BB_tape112: bets $0.08
sibir555: folds
Uncalled bet ($0.08) returned to BB_tape112
BB_tape112 collected $0.10 from pot
BB_tape112: doesn't show hand
*** SUMMARY ***
Total pot $0.10 | Rake $0
Board [4s 7c Th Ks]
Seat 1: Ganseku Nagi folded before Flop (didn't bet)
Seat 2: sibir555 (button) folded on the Turn
Seat 4: BB_tape112 (small blind) collected ($0.10)
Seat 5: Soranton (big blind) folded before Flop
Seat 6: Benzer586 folded before Flop (didn't bet)


*********** # 47 **************
PokerStars Hand #197157880973:  Hold'em No Limit ($0.01/$0.02 USD) - 2019/02/17 7:27:21 ET
Table 'Coppelia III' 6-max Seat #1 is the button
Seat 1: Ganseku Nagi ($4.15 in chips)
Seat 2: sibir555 ($2.92 in chips)
Seat 4: BB_tape112 ($2.10 in chips)
Seat 5: Soranton ($2.92 in chips)
Seat 6: Benzer586 ($1.86 in chips)
sibir555: posts small blind $0.01
GRizlik14: is sitting out
BB_tape112: posts big blind $0.02
*** HOLE CARDS ***
Dealt to Benzer586 [Qc Ac]
Soranton: folds
GRizlik14 leaves the table
Benzer586: raises $0.02 to $0.04
Ganseku Nagi: folds
sibir555: folds
Maksim538 joins the table at seat #3
BB_tape112: folds
Uncalled bet ($0.02) returned to Benzer586
Benzer586 collected $0.05 from pot
Benzer586: doesn't show hand
*** SUMMARY ***
Total pot $0.05 | Rake $0
Seat 1: Ganseku Nagi (button) folded before Flop (didn't bet)
Seat 2: sibir555 (small blind) folded before Flop
Seat 4: BB_tape112 (big blind) folded before Flop
Seat 5: Soranton folded before Flop (didn't bet)
Seat 6: Benzer586 collected ($0.05)


*********** # 48 **************
PokerStars Hand #197157873452:  Hold'em No Limit ($0.01/$0.02 USD) - 2019/02/17 7:27:05 ET
Table 'Coppelia III' 6-max Seat #6 is the button
Seat 1: Ganseku Nagi ($4.16 in chips)
Seat 2: sibir555 ($2.91 in chips)
Seat 3: GRizlik14 ($2.03 in chips)
Seat 4: BB_tape112 ($2.10 in chips)
Seat 5: Soranton ($2.92 in chips)
Seat 6: Benzer586 ($1.86 in chips)
Ganseku Nagi: posts small blind $0.01
sibir555: posts big blind $0.02
*** HOLE CARDS ***
Dealt to Benzer586 [8s Th]
GRizlik14: folds
BB_tape112: folds
Soranton: folds
Benzer586: folds
Ganseku Nagi: folds
Uncalled bet ($0.01) returned to sibir555
sibir555 collected $0.02 from pot
*** SUMMARY ***
Total pot $0.02 | Rake $0
Seat 1: Ganseku Nagi (small blind) folded before Flop
Seat 2: sibir555 (big blind) collected ($0.02)
Seat 3: GRizlik14 folded before Flop (didn't bet)
Seat 4: BB_tape112 folded before Flop (didn't bet)
Seat 5: Soranton folded before Flop (didn't bet)
Seat 6: Benzer586 (button) folded before Flop (didn't bet)


*********** # 49 **************
PokerStars Hand #197157861957:  Hold'em No Limit ($0.01/$0.02 USD) - 2019/02/17 7:26:40 ET
Table 'Coppelia III' 6-max Seat #5 is the button
Seat 1: Ganseku Nagi ($4.18 in chips)
Seat 2: sibir555 ($2.91 in chips)
Seat 3: GRizlik14 ($2 in chips)
Seat 4: BB_tape112 ($2.10 in chips)
Seat 5: Soranton ($2.92 in chips)
Seat 6: Benzer586 ($1.87 in chips)
Benzer586: posts small blind $0.01
Ganseku Nagi: posts big blind $0.02
*** HOLE CARDS ***
Dealt to Benzer586 [4s 4h]
sibir555: folds
GRizlik14: raises $0.03 to $0.05
BB_tape112: folds
Soranton: folds
Benzer586: folds
Ganseku Nagi: folds
Uncalled bet ($0.03) returned to GRizlik14
GRizlik14 collected $0.05 from pot
GRizlik14: doesn't show hand
*** SUMMARY ***
Total pot $0.05 | Rake $0
Seat 1: Ganseku Nagi (big blind) folded before Flop
Seat 2: sibir555 folded before Flop (didn't bet)
Seat 3: GRizlik14 collected ($0.05)
Seat 4: BB_tape112 folded before Flop (didn't bet)
Seat 5: Soranton (button) folded before Flop (didn't bet)
Seat 6: Benzer586 (small blind) folded before Flop


*********** # 50 **************
PokerStars Hand #197157846044:  Hold'em No Limit ($0.01/$0.02 USD) - 2019/02/17 7:26:05 ET
Table 'Coppelia III' 6-max Seat #4 is the button
Seat 1: Ganseku Nagi ($4.18 in chips)
Seat 2: sibir555 ($2.91 in chips)
Seat 3: GRizlik14 ($2 in chips)
Seat 4: BB_tape112 ($2.10 in chips)
Seat 5: Soranton ($2.86 in chips)
Seat 6: Benzer586 ($1.93 in chips)
Soranton: posts small blind $0.01
Benzer586: posts big blind $0.02
*** HOLE CARDS ***
Dealt to Benzer586 [As Jd]
Ganseku Nagi: folds
sibir555: folds
GRizlik14: folds
BB_tape112: folds
Soranton: raises $0.04 to $0.06
Benzer586: calls $0.04
*** FLOP *** [Ks Tc Ts]
Soranton: bets $0.08
Benzer586: folds
Uncalled bet ($0.08) returned to Soranton
Soranton collected $0.12 from pot
Soranton: doesn't show hand
*** SUMMARY ***
Total pot $0.12 | Rake $0
Board [Ks Tc Ts]
Seat 1: Ganseku Nagi folded before Flop (didn't bet)
Seat 2: sibir555 folded before Flop (didn't bet)
Seat 3: GRizlik14 folded before Flop (didn't bet)
Seat 4: BB_tape112 (button) folded before Flop (didn't bet)
Seat 5: Soranton (small blind) collected ($0.12)
Seat 6: Benzer586 (big blind) folded on the Flop


*********** # 51 **************
PokerStars Hand #197157821465:  Hold'em No Limit ($0.01/$0.02 USD) - 2019/02/17 7:25:12 ET
Table 'Coppelia III' 6-max Seat #3 is the button
Seat 1: Ganseku Nagi ($4.18 in chips)
Seat 2: sibir555 ($2.91 in chips)
Seat 3: GRizlik14 ($2 in chips)
Seat 4: BB_tape112 ($2.01 in chips)
Seat 5: Soranton ($2.90 in chips)
Seat 6: Benzer586 ($1.99 in chips)
BB_tape112: posts small blind $0.01
Soranton: posts big blind $0.02
*** HOLE CARDS ***
Dealt to Benzer586 [4s 4d]
Benzer586: raises $0.02 to $0.04
Ganseku Nagi: folds
sibir555: folds
GRizlik14: folds
BB_tape112: calls $0.03
Soranton: calls $0.02
*** FLOP *** [9s 6s Kd]
BB_tape112: checks
Soranton: checks
Benzer586: bets $0.02
BB_tape112: calls $0.02
Soranton: folds
*** TURN *** [9s 6s Kd] [Js]
BB_tape112: checks
Benzer586: checks
*** RIVER *** [9s 6s Kd Js] [7h]
BB_tape112: checks
Benzer586: checks
*** SHOW DOWN ***
BB_tape112: shows [5c 5s] (a pair of Fives)
Benzer586: mucks hand
BB_tape112 collected $0.15 from pot
*** SUMMARY ***
Total pot $0.16 | Rake $0.01
Board [9s 6s Kd Js 7h]
Seat 1: Ganseku Nagi folded before Flop (didn't bet)
Seat 2: sibir555 folded before Flop (didn't bet)
Seat 3: GRizlik14 (button) folded before Flop (didn't bet)
Seat 4: BB_tape112 (small blind) showed [5c 5s] and won ($0.15) with a pair of Fives
Seat 5: Soranton (big blind) folded on the Flop
Seat 6: Benzer586 mucked [4s 4d]


*********** # 52 **************
PokerStars Hand #197157815665:  Hold'em No Limit ($0.01/$0.02 USD) - 2019/02/17 7:24:59 ET
Table 'Coppelia III' 6-max Seat #2 is the button
Seat 1: Ganseku Nagi ($4.18 in chips)
Seat 2: sibir555 ($2.91 in chips)
Seat 3: GRizlik14 ($2 in chips)
Seat 4: BB_tape112 ($2 in chips)
Seat 5: Soranton ($2.90 in chips)
Seat 6: Benzer586 ($1.99 in chips)
GRizlik14: posts small blind $0.01
BB_tape112: posts big blind $0.02
*** HOLE CARDS ***
Dealt to Benzer586 [4c Qc]
Soranton: folds
Benzer586: folds
Ganseku Nagi: folds
sibir555: folds
GRizlik14: folds
Uncalled bet ($0.01) returned to BB_tape112
BB_tape112 collected $0.02 from pot
BB_tape112: doesn't show hand
*** SUMMARY ***
Total pot $0.02 | Rake $0
Seat 1: Ganseku Nagi folded before Flop (didn't bet)
Seat 2: sibir555 (button) folded before Flop (didn't bet)
Seat 3: GRizlik14 (small blind) folded before Flop
Seat 4: BB_tape112 (big blind) collected ($0.02)
Seat 5: Soranton folded before Flop (didn't bet)
Seat 6: Benzer586 folded before Flop (didn't bet)


*********** # 53 **************
PokerStars Hand #197157807613:  Hold'em No Limit ($0.01/$0.02 USD) - 2019/02/17 7:24:42 ET
Table 'Coppelia III' 6-max Seat #1 is the button
Seat 1: Ganseku Nagi ($4.12 in chips)
Seat 2: sibir555 ($2.95 in chips)
Seat 3: GRizlik14 ($2 in chips)
Seat 4: BB_tape112 ($2 in chips)
Seat 5: Soranton ($2.90 in chips)
Seat 6: Benzer586 ($1.99 in chips)
sibir555: posts small blind $0.01
GRizlik14: posts big blind $0.02
*** HOLE CARDS ***
Dealt to Benzer586 [Td 6d]
BB_tape112: folds
Soranton: folds
Benzer586: folds
Ganseku Nagi: raises $0.02 to $0.04
sibir555: calls $0.03
GRizlik14: folds
*** FLOP *** [5c 4c 8s]
sibir555: checks
Ganseku Nagi: bets $0.10
sibir555: folds
Uncalled bet ($0.10) returned to Ganseku Nagi
Ganseku Nagi collected $0.10 from pot
Ganseku Nagi: doesn't show hand
*** SUMMARY ***
Total pot $0.10 | Rake $0
Board [5c 4c 8s]
Seat 1: Ganseku Nagi (button) collected ($0.10)
Seat 2: sibir555 (small blind) folded on the Flop
Seat 3: GRizlik14 (big blind) folded before Flop
Seat 4: BB_tape112 folded before Flop (didn't bet)
Seat 5: Soranton folded before Flop (didn't bet)
Seat 6: Benzer586 folded before Flop (didn't bet)


*********** # 54 **************
PokerStars Hand #197157796256:  Hold'em No Limit ($0.01/$0.02 USD) - 2019/02/17 7:24:17 ET
Table 'Coppelia III' 6-max Seat #6 is the button
Seat 1: Ganseku Nagi ($4.06 in chips)
Seat 2: sibir555 ($3.01 in chips)
Seat 3: GRizlik14 ($2 in chips)
Seat 4: BB_tape112 ($2 in chips)
Seat 5: Soranton ($2.90 in chips)
Seat 6: Benzer586 ($1.99 in chips)
Ganseku Nagi: posts small blind $0.01
sibir555: posts big blind $0.02
*** HOLE CARDS ***
Dealt to Benzer586 [5h Ac]
GRizlik14: folds
BB_tape112: folds
Soranton: folds
Benzer586: folds
Ganseku Nagi: raises $0.04 to $0.06
sibir555: calls $0.04
*** FLOP *** [Ks Qs 7d]
Ganseku Nagi: bets $0.10
sibir555: folds
Uncalled bet ($0.10) returned to Ganseku Nagi
Ganseku Nagi collected $0.12 from pot
Ganseku Nagi: doesn't show hand
*** SUMMARY ***
Total pot $0.12 | Rake $0
Board [Ks Qs 7d]
Seat 1: Ganseku Nagi (small blind) collected ($0.12)
Seat 2: sibir555 (big blind) folded on the Flop
Seat 3: GRizlik14 folded before Flop (didn't bet)
Seat 4: BB_tape112 folded before Flop (didn't bet)
Seat 5: Soranton folded before Flop (didn't bet)
Seat 6: Benzer586 (button) folded before Flop (didn't bet)


*********** # 55 **************
PokerStars Hand #197157786823:  Hold'em No Limit ($0.01/$0.02 USD) - 2019/02/17 7:23:56 ET
Table 'Coppelia III' 6-max Seat #5 is the button
Seat 1: Ganseku Nagi ($4.08 in chips)
Seat 2: sibir555 ($3.01 in chips)
Seat 3: GRizlik14 ($2 in chips)
Seat 4: BB_tape112 ($2 in chips)
Seat 5: Soranton ($2.90 in chips)
Seat 6: Benzer586 ($1.97 in chips)
Benzer586: posts small blind $0.01
Ganseku Nagi: posts big blind $0.02
*** HOLE CARDS ***
Dealt to Benzer586 [As 8d]
sibir555: folds
GRizlik14: folds
BB_tape112: folds
Soranton: folds
Benzer586: raises $0.02 to $0.04
Ganseku Nagi: folds
Uncalled bet ($0.02) returned to Benzer586
Benzer586 collected $0.04 from pot
Benzer586: doesn't show hand
*** SUMMARY ***
Total pot $0.04 | Rake $0
Seat 1: Ganseku Nagi (big blind) folded before Flop
Seat 2: sibir555 folded before Flop (didn't bet)
Seat 3: GRizlik14 folded before Flop (didn't bet)
Seat 4: BB_tape112 folded before Flop (didn't bet)
Seat 5: Soranton (button) folded before Flop (didn't bet)
Seat 6: Benzer586 (small blind) collected ($0.04)


*********** # 56 **************
PokerStars Hand #197157780972:  Hold'em No Limit ($0.01/$0.02 USD) - 2019/02/17 7:23:44 ET
Table 'Coppelia III' 6-max Seat #4 is the button
Seat 1: Ganseku Nagi ($4.08 in chips)
Seat 2: sibir555 ($2.98 in chips)
Seat 3: GRizlik14 ($2 in chips)
Seat 4: BB_tape112 ($2 in chips)
Seat 5: Soranton ($2.91 in chips)
Seat 6: Benzer586 ($1.99 in chips)
Soranton: posts small blind $0.01
Benzer586: posts big blind $0.02
*** HOLE CARDS ***
Dealt to Benzer586 [Tc 6h]
Ganseku Nagi: folds
sibir555: raises $0.03 to $0.05
GRizlik14: folds
BB_tape112: folds
Soranton: folds
Benzer586: folds
Uncalled bet ($0.03) returned to sibir555
sibir555 collected $0.05 from pot
*** SUMMARY ***
Total pot $0.05 | Rake $0
Seat 1: Ganseku Nagi folded before Flop (didn't bet)
Seat 2: sibir555 collected ($0.05)
Seat 3: GRizlik14 folded before Flop (didn't bet)
Seat 4: BB_tape112 (button) folded before Flop (didn't bet)
Seat 5: Soranton (small blind) folded before Flop
Seat 6: Benzer586 (big blind) folded before Flop


*********** # 57 **************
PokerStars Hand #197157757533:  Hold'em No Limit ($0.01/$0.02 USD) - 2019/02/17 7:22:53 ET
Table 'Coppelia III' 6-max Seat #3 is the button
Seat 1: Ganseku Nagi ($4.08 in chips)
Seat 2: sibir555 ($2.88 in chips)
Seat 3: GRizlik14 ($2 in chips)
Seat 4: BB_tape112 ($2 in chips)
Seat 5: Soranton ($2.96 in chips)
Seat 6: Benzer586 ($1.99 in chips)
BB_tape112: posts small blind $0.01
Soranton: posts big blind $0.02
*** HOLE CARDS ***
Dealt to Benzer586 [2s 5c]
Benzer586: folds
Ganseku Nagi: folds
sibir555: raises $0.03 to $0.05
GRizlik14: calls $0.05
BB_tape112: folds
Soranton: calls $0.03
*** FLOP *** [2h Kd Ac]
Soranton: checks
sibir555: checks
GRizlik14: checks
*** TURN *** [2h Kd Ac] [As]
Soranton: checks
sibir555: checks
GRizlik14: checks
*** RIVER *** [2h Kd Ac As] [Kh]
Soranton: checks
sibir555: checks
GRizlik14: checks
*** SHOW DOWN ***
Soranton: shows [3d 3h] (two pair, Aces and Kings)
sibir555: shows [Jc 9c] (two pair, Aces and Kings - Jack kicker)
GRizlik14: mucks hand
sibir555 collected $0.15 from pot
*** SUMMARY ***
Total pot $0.16 | Rake $0.01
Board [2h Kd Ac As Kh]
Seat 1: Ganseku Nagi folded before Flop (didn't bet)
Seat 2: sibir555 showed [Jc 9c] and won ($0.15) with two pair, Aces and Kings
Seat 3: GRizlik14 (button) mucked [3c 3s]
Seat 4: BB_tape112 (small blind) folded before Flop
Seat 5: Soranton (big blind) showed [3d 3h] and lost with two pair, Aces and Kings
Seat 6: Benzer586 folded before Flop (didn't bet)


*********** # 58 **************
PokerStars Hand #197157732030:  Hold'em No Limit ($0.01/$0.02 USD) - 2019/02/17 7:21:57 ET
Table 'Coppelia III' 6-max Seat #2 is the button
Seat 1: Ganseku Nagi ($4.08 in chips)
Seat 2: sibir555 ($2.83 in chips)
Seat 3: GRizlik14 ($2 in chips)
Seat 4: BB_tape112 ($2 in chips)
Seat 5: Soranton ($2.96 in chips)
Seat 6: Benzer586 ($1.99 in chips)
GRizlik14: posts small blind $0.01
BB_tape112: posts big blind $0.02
*** HOLE CARDS ***
Dealt to Benzer586 [4c 9h]
Soranton: folds
Benzer586: folds
Ganseku Nagi: folds
sibir555: raises $0.02 to $0.04
GRizlik14: folds
BB_tape112: calls $0.02
*** FLOP *** [Tc 7s Kh]
BB_tape112 has timed out
BB_tape112: checks
sibir555: bets $0.05
BB_tape112: folds
Uncalled bet ($0.05) returned to sibir555
sibir555 collected $0.09 from pot
*** SUMMARY ***
Total pot $0.09 | Rake $0
Board [Tc 7s Kh]
Seat 1: Ganseku Nagi folded before Flop (didn't bet)
Seat 2: sibir555 (button) collected ($0.09)
Seat 3: GRizlik14 (small blind) folded before Flop
Seat 4: BB_tape112 (big blind) folded on the Flop
Seat 5: Soranton folded before Flop (didn't bet)
Seat 6: Benzer586 folded before Flop (didn't bet)


*********** # 59 **************
PokerStars Hand #197157721585:  Hold'em No Limit ($0.01/$0.02 USD) - 2019/02/17 7:21:35 ET
Table 'Coppelia III' 6-max Seat #1 is the button
Seat 1: Ganseku Nagi ($4.05 in chips)
Seat 2: sibir555 ($2.84 in chips)
Seat 3: GRizlik14 ($2 in chips)
Seat 5: Soranton ($2.96 in chips)
Seat 6: Benzer586 ($1.99 in chips)
sibir555: posts small blind $0.01
GRizlik14: posts big blind $0.02
BB_tape112: sits out
*** HOLE CARDS ***
Dealt to Benzer586 [3c 5s]
Soranton: folds
Benzer586: folds
Ganseku Nagi: raises $0.04 to $0.06
sibir555: folds
GRizlik14: folds
Uncalled bet ($0.04) returned to Ganseku Nagi
Ganseku Nagi collected $0.05 from pot
Ganseku Nagi: doesn't show hand
*** SUMMARY ***
Total pot $0.05 | Rake $0
Seat 1: Ganseku Nagi (button) collected ($0.05)
Seat 2: sibir555 (small blind) folded before Flop
Seat 3: GRizlik14 (big blind) folded before Flop
Seat 5: Soranton folded before Flop (didn't bet)
Seat 6: Benzer586 folded before Flop (didn't bet)


*********** # 60 **************
PokerStars Hand #197157705188:  Hold'em No Limit ($0.01/$0.02 USD) - 2019/02/17 7:20:59 ET
Table 'Coppelia III' 6-max Seat #6 is the button
Seat 1: Ganseku Nagi ($4.06 in chips)
Seat 2: sibir555 ($2.86 in chips)
Seat 3: azx838 ($4.47 in chips)
Seat 5: Soranton ($2.96 in chips)
Seat 6: Benzer586 ($1.96 in chips)
Ganseku Nagi: posts small blind $0.01
sibir555: posts big blind $0.02
BB_tape112: sits out
*** HOLE CARDS ***
Dealt to Benzer586 [Tc Js]
azx838: folds
azx838 leaves the table
Soranton: folds
Benzer586: calls $0.02
Ganseku Nagi: folds
GRizlik14 joins the table at seat #3
sibir555: checks
*** FLOP *** [4h Ac Ad]
sibir555: checks
Benzer586: checks
*** TURN *** [4h Ac Ad] [Th]
sibir555: checks
Benzer586: bets $0.04
sibir555: folds
Uncalled bet ($0.04) returned to Benzer586
Benzer586 collected $0.05 from pot
Benzer586: doesn't show hand
*** SUMMARY ***
Total pot $0.05 | Rake $0
Board [4h Ac Ad Th]
Seat 1: Ganseku Nagi (small blind) folded before Flop
Seat 2: sibir555 (big blind) folded on the Turn
Seat 3: azx838 folded before Flop (didn't bet)
Seat 5: Soranton folded before Flop (didn't bet)
Seat 6: Benzer586 (button) collected ($0.05)


*********** # 61 **************
PokerStars Hand #197157694938:  Hold'em No Limit ($0.01/$0.02 USD) - 2019/02/17 7:20:36 ET
Table 'Coppelia III' 6-max Seat #5 is the button
Seat 1: Ganseku Nagi ($4.08 in chips)
Seat 2: sibir555 ($2.83 in chips)
Seat 3: azx838 ($4.47 in chips)
Seat 5: Soranton ($2.96 in chips)
Seat 6: Benzer586 ($1.97 in chips)
Benzer586: posts small blind $0.01
Ganseku Nagi: posts big blind $0.02
ykAtt: sits out
*** HOLE CARDS ***
Dealt to Benzer586 [8h Th]
ykAtt leaves the table
sibir555: raises $0.03 to $0.05
azx838: folds
Soranton: folds
BB_tape112 joins the table at seat #4
Benzer586: folds
Ganseku Nagi: folds
Uncalled bet ($0.03) returned to sibir555
sibir555 collected $0.05 from pot
*** SUMMARY ***
Total pot $0.05 | Rake $0
Seat 1: Ganseku Nagi (big blind) folded before Flop
Seat 2: sibir555 collected ($0.05)
Seat 3: azx838 folded before Flop (didn't bet)
Seat 5: Soranton (button) folded before Flop (didn't bet)
Seat 6: Benzer586 (small blind) folded before Flop


*********** # 62 **************
PokerStars Hand #197157681675:  Hold'em No Limit ($0.01/$0.02 USD) - 2019/02/17 7:20:07 ET
Table 'Coppelia III' 6-max Seat #3 is the button
Seat 1: Ganseku Nagi ($4.08 in chips)
Seat 2: sibir555 ($2.83 in chips)
Seat 3: azx838 ($4.47 in chips)
Seat 5: Soranton ($3.16 in chips)
Seat 6: Benzer586 ($1.78 in chips)
Soranton: posts small blind $0.01
Benzer586: posts big blind $0.02
*** HOLE CARDS ***
Dealt to Benzer586 [6d 7d]
Ganseku Nagi: folds
sibir555: folds
azx838: folds
Soranton: raises $0.04 to $0.06
ykAtt joins the table at seat #4
Benzer586: calls $0.04
*** FLOP *** [Kh Ad 6h]
Soranton: checks
Benzer586: bets $0.02
Soranton: calls $0.02
*** TURN *** [Kh Ad 6h] [6c]
Soranton: bets $0.06
Benzer586: raises $0.06 to $0.12
Soranton: calls $0.06
*** RIVER *** [Kh Ad 6h 6c] [5s]
Soranton: checks
Benzer586: checks
*** SHOW DOWN ***
Soranton: shows [As 3h] (two pair, Aces and Sixes)
Benzer586: shows [6d 7d] (three of a kind, Sixes)
Benzer586 collected $0.39 from pot
*** SUMMARY ***
Total pot $0.40 | Rake $0.01
Board [Kh Ad 6h 6c 5s]
Seat 1: Ganseku Nagi folded before Flop (didn't bet)
Seat 2: sibir555 folded before Flop (didn't bet)
Seat 3: azx838 (button) folded before Flop (didn't bet)
Seat 5: Soranton (small blind) showed [As 3h] and lost with two pair, Aces and Sixes
Seat 6: Benzer586 (big blind) showed [6d 7d] and won ($0.39) with three of a kind, Sixes


*********** # 63 **************
PokerStars Hand #197157673902:  Hold'em No Limit ($0.01/$0.02 USD) - 2019/02/17 7:19:51 ET
Table 'Coppelia III' 6-max Seat #2 is the button
Seat 1: Ganseku Nagi ($4.08 in chips)
Seat 2: sibir555 ($2.83 in chips)
Seat 3: azx838 ($4.48 in chips)
Seat 5: Soranton ($3.15 in chips)
Seat 6: Benzer586 ($1.78 in chips)
azx838: posts small blind $0.01
Soranton: posts big blind $0.02
*** HOLE CARDS ***
Dealt to Benzer586 [5c 6s]
Benzer586: folds
Ganseku Nagi: folds
sibir555: folds
azx838: folds
Uncalled bet ($0.01) returned to Soranton
Soranton collected $0.02 from pot
Soranton: doesn't show hand
*** SUMMARY ***
Total pot $0.02 | Rake $0
Seat 1: Ganseku Nagi folded before Flop (didn't bet)
Seat 2: sibir555 (button) folded before Flop (didn't bet)
Seat 3: azx838 (small blind) folded before Flop
Seat 5: Soranton (big blind) collected ($0.02)
Seat 6: Benzer586 folded before Flop (didn't bet)


*********** # 64 **************
PokerStars Hand #197157667483:  Hold'em No Limit ($0.01/$0.02 USD) - 2019/02/17 7:19:37 ET
Table 'Coppelia III' 6-max Seat #1 is the button
Seat 1: Ganseku Nagi ($4.08 in chips)
Seat 2: sibir555 ($2.81 in chips)
Seat 3: azx838 ($4.50 in chips)
Seat 5: Soranton ($3.15 in chips)
Seat 6: Benzer586 ($1.78 in chips)
sibir555: posts small blind $0.01
azx838: posts big blind $0.02
*** HOLE CARDS ***
Dealt to Benzer586 [6d 4h]
Soranton: folds
Benzer586: folds
Ganseku Nagi: folds
19VITALIY86 leaves the table
sibir555: raises $0.04 to $0.06
azx838: folds
Uncalled bet ($0.04) returned to sibir555
sibir555 collected $0.04 from pot
*** SUMMARY ***
Total pot $0.04 | Rake $0
Seat 1: Ganseku Nagi (button) folded before Flop (didn't bet)
Seat 2: sibir555 (small blind) collected ($0.04)
Seat 3: azx838 (big blind) folded before Flop
Seat 5: Soranton folded before Flop (didn't bet)
Seat 6: Benzer586 folded before Flop (didn't bet)


*********** # 65 **************
PokerStars Hand #197157649693:  Hold'em No Limit ($0.01/$0.02 USD) - 2019/02/17 7:18:58 ET
Table 'Coppelia III' 6-max Seat #6 is the button
Seat 1: Ganseku Nagi ($4.09 in chips)
Seat 2: sibir555 ($2.83 in chips)
Seat 3: azx838 ($4.50 in chips)
Seat 4: 19VITALIY86 ($0.44 in chips)
Seat 5: Soranton ($2.71 in chips)
Seat 6: Benzer586 ($1.78 in chips)
Ganseku Nagi: posts small blind $0.01
sibir555: posts big blind $0.02
*** HOLE CARDS ***
Dealt to Benzer586 [4s Qc]
azx838: folds
19VITALIY86: raises $0.04 to $0.06
Soranton: calls $0.06
Benzer586: folds
Ganseku Nagi: folds
sibir555: folds
*** FLOP *** [7h 7d 7c]
19VITALIY86: bets $0.38 and is all-in
Soranton: calls $0.38
*** TURN *** [7h 7d 7c] [5d]
*** RIVER *** [7h 7d 7c 5d] [4d]
*** SHOW DOWN ***
19VITALIY86: shows [Jc Ac] (three of a kind, Sevens)
Soranton: shows [6s 6d] (a full house, Sevens full of Sixes)
Soranton collected $0.88 from pot
*** SUMMARY ***
Total pot $0.91 | Rake $0.03
Board [7h 7d 7c 5d 4d]
Seat 1: Ganseku Nagi (small blind) folded before Flop
Seat 2: sibir555 (big blind) folded before Flop
Seat 3: azx838 folded before Flop (didn't bet)
Seat 4: 19VITALIY86 showed [Jc Ac] and lost with three of a kind, Sevens
Seat 5: Soranton showed [6s 6d] and won ($0.88) with a full house, Sevens full of Sixes
Seat 6: Benzer586 (button) folded before Flop (didn't bet)


*********** # 66 **************
PokerStars Hand #197157641159:  Hold'em No Limit ($0.01/$0.02 USD) - 2019/02/17 7:18:39 ET
Table 'Coppelia III' 6-max Seat #5 is the button
Seat 1: Ganseku Nagi ($4.11 in chips)
Seat 2: sibir555 ($2.80 in chips)
Seat 3: azx838 ($4.50 in chips)
Seat 4: 19VITALIY86 ($0.44 in chips)
Seat 5: Soranton ($2.71 in chips)
Seat 6: Benzer586 ($1.79 in chips)
Benzer586: posts small blind $0.01
Ganseku Nagi: posts big blind $0.02
*** HOLE CARDS ***
Dealt to Benzer586 [7s Ah]
sibir555: raises $0.03 to $0.05
azx838: folds
19VITALIY86: folds
Soranton: folds
Benzer586: folds
Ganseku Nagi: folds
Uncalled bet ($0.03) returned to sibir555
sibir555 collected $0.05 from pot
*** SUMMARY ***
Total pot $0.05 | Rake $0
Seat 1: Ganseku Nagi (big blind) folded before Flop
Seat 2: sibir555 collected ($0.05)
Seat 3: azx838 folded before Flop (didn't bet)
Seat 4: 19VITALIY86 folded before Flop (didn't bet)
Seat 5: Soranton (button) folded before Flop (didn't bet)
Seat 6: Benzer586 (small blind) folded before Flop


*********** # 67 **************
PokerStars Hand #197157634580:  Hold'em No Limit ($0.01/$0.02 USD) - 2019/02/17 7:18:25 ET
Table 'Coppelia III' 6-max Seat #4 is the button
Seat 1: Ganseku Nagi ($4.11 in chips)
Seat 2: sibir555 ($2.80 in chips)
Seat 3: azx838 ($4.50 in chips)
Seat 4: 19VITALIY86 ($0.44 in chips)
Seat 5: Soranton ($2.72 in chips)
Seat 6: Benzer586 ($1.78 in chips)
Soranton: posts small blind $0.01
Benzer586: posts big blind $0.02
*** HOLE CARDS ***
Dealt to Benzer586 [8d Ts]
Ganseku Nagi: folds
sibir555: folds
azx838: folds
19VITALIY86: folds
Soranton: folds
Uncalled bet ($0.01) returned to Benzer586
Benzer586 collected $0.02 from pot
Benzer586: doesn't show hand
*** SUMMARY ***
Total pot $0.02 | Rake $0
Seat 1: Ganseku Nagi folded before Flop (didn't bet)
Seat 2: sibir555 folded before Flop (didn't bet)
Seat 3: azx838 folded before Flop (didn't bet)
Seat 4: 19VITALIY86 (button) folded before Flop (didn't bet)
Seat 5: Soranton (small blind) folded before Flop
Seat 6: Benzer586 (big blind) collected ($0.02)


*********** # 68 **************
PokerStars Hand #197157608744:  Hold'em No Limit ($0.01/$0.02 USD) - 2019/02/17 7:17:29 ET
Table 'Coppelia III' 6-max Seat #3 is the button
Seat 1: Ganseku Nagi ($4.11 in chips)
Seat 2: sibir555 ($2.80 in chips)
Seat 3: azx838 ($4.68 in chips)
Seat 4: 19VITALIY86 ($0.45 in chips)
Seat 5: Soranton ($2.74 in chips)
Seat 6: Benzer586 ($1.58 in chips)
19VITALIY86: posts small blind $0.01
Soranton: posts big blind $0.02
*** HOLE CARDS ***
Dealt to Benzer586 [5c 5h]
Benzer586: calls $0.02
Ganseku Nagi: folds
sibir555: folds
azx838: calls $0.02
19VITALIY86: folds
Soranton: checks
*** FLOP *** [9h 5d 3c]
Soranton: checks
Benzer586: bets $0.02
azx838: calls $0.02
Soranton: folds
*** TURN *** [9h 5d 3c] [7c]
Benzer586: bets $0.10
azx838: calls $0.10
*** RIVER *** [9h 5d 3c 7c] [3d]
Benzer586: bets $0.04
azx838: calls $0.04
*** SHOW DOWN ***
Benzer586: shows [5c 5h] (a full house, Fives full of Threes)
azx838: mucks hand
Benzer586 collected $0.38 from pot
*** SUMMARY ***
Total pot $0.39 | Rake $0.01
Board [9h 5d 3c 7c 3d]
Seat 1: Ganseku Nagi folded before Flop (didn't bet)
Seat 2: sibir555 folded before Flop (didn't bet)
Seat 3: azx838 (button) mucked [7d Qd]
Seat 4: 19VITALIY86 (small blind) folded before Flop
Seat 5: Soranton (big blind) folded on the Flop
Seat 6: Benzer586 showed [5c 5h] and won ($0.38) with a full house, Fives full of Threes


*********** # 69 **************
PokerStars Hand #197157594196:  Hold'em No Limit ($0.01/$0.02 USD) - 2019/02/17 7:16:57 ET
Table 'Coppelia III' 6-max Seat #2 is the button
Seat 1: Ganseku Nagi ($4.11 in chips)
Seat 2: sibir555 ($2.75 in chips)
Seat 3: azx838 ($4.69 in chips)
Seat 4: 19VITALIY86 ($0.47 in chips)
Seat 5: Soranton ($2.74 in chips)
Seat 6: Benzer586 ($1.60 in chips)
azx838: posts small blind $0.01
19VITALIY86: posts big blind $0.02
*** HOLE CARDS ***
Dealt to Benzer586 [8h Ac]
Soranton: folds
Benzer586: calls $0.02
Ganseku Nagi: folds
sibir555: raises $0.07 to $0.09
azx838: folds
19VITALIY86: folds
Benzer586: folds
Uncalled bet ($0.07) returned to sibir555
sibir555 collected $0.07 from pot
*** SUMMARY ***
Total pot $0.07 | Rake $0
Seat 1: Ganseku Nagi folded before Flop (didn't bet)
Seat 2: sibir555 (button) collected ($0.07)
Seat 3: azx838 (small blind) folded before Flop
Seat 4: 19VITALIY86 (big blind) folded before Flop
Seat 5: Soranton folded before Flop (didn't bet)
Seat 6: Benzer586 folded before Flop


*********** # 70 **************
PokerStars Hand #197157569229:  Hold'em No Limit ($0.01/$0.02 USD) - 2019/02/17 7:16:02 ET
Table 'Coppelia III' 6-max Seat #1 is the button
Seat 1: Ganseku Nagi ($4.21 in chips)
Seat 2: sibir555 ($2.76 in chips)
Seat 3: azx838 ($4.59 in chips)
Seat 5: Soranton ($2.74 in chips)
Seat 6: Benzer586 ($1.60 in chips)
sibir555: posts small blind $0.01
azx838: posts big blind $0.02
*** HOLE CARDS ***
Dealt to Benzer586 [Tc 7d]
Soranton: folds
Benzer586: folds
Ganseku Nagi: raises $0.02 to $0.04
sibir555: folds
azx838: calls $0.02
*** FLOP *** [5c 4d 3c]
azx838: bets $0.06
Ganseku Nagi: calls $0.06
*** TURN *** [5c 4d 3c] [Jc]
azx838: checks
Ganseku Nagi: checks
*** RIVER *** [5c 4d 3c Jc] [5s]
azx838: checks
Ganseku Nagi: checks
*** SHOW DOWN ***
azx838: shows [Kh 4h] (two pair, Fives and Fours)
Ganseku Nagi: mucks hand
azx838 collected $0.20 from pot
*** SUMMARY ***
Total pot $0.21 | Rake $0.01
Board [5c 4d 3c Jc 5s]
Seat 1: Ganseku Nagi (button) mucked [8h 6h]
Seat 2: sibir555 (small blind) folded before Flop
Seat 3: azx838 (big blind) showed [Kh 4h] and won ($0.20) with two pair, Fives and Fours
Seat 5: Soranton folded before Flop (didn't bet)
Seat 6: Benzer586 folded before Flop (didn't bet)


*********** # 71 **************
PokerStars Hand #197157559059:  Hold'em No Limit ($0.01/$0.02 USD) - 2019/02/17 7:15:39 ET
Table 'Coppelia III' 6-max Seat #6 is the button
Seat 1: Ganseku Nagi ($4.19 in chips)
Seat 2: sibir555 ($2.78 in chips)
Seat 3: azx838 ($4.59 in chips)
Seat 4: 19VITALIY86 ($0.47 in chips)
Seat 5: Soranton ($2.74 in chips)
Seat 6: Benzer586 ($1.60 in chips)
Ganseku Nagi: posts small blind $0.01
sibir555: posts big blind $0.02
*** HOLE CARDS ***
Dealt to Benzer586 [Qc 2h]
azx838: folds
19VITALIY86 has timed out
19VITALIY86: folds
Soranton: folds
Benzer586: folds
Ganseku Nagi: raises $0.04 to $0.06
sibir555: folds
Uncalled bet ($0.04) returned to Ganseku Nagi
Ganseku Nagi collected $0.04 from pot
Ganseku Nagi: doesn't show hand
*** SUMMARY ***
Total pot $0.04 | Rake $0
Seat 1: Ganseku Nagi (small blind) collected ($0.04)
Seat 2: sibir555 (big blind) folded before Flop
Seat 3: azx838 folded before Flop (didn't bet)
Seat 4: 19VITALIY86 folded before Flop (didn't bet)
Seat 5: Soranton folded before Flop (didn't bet)
Seat 6: Benzer586 (button) folded before Flop (didn't bet)


*********** # 72 **************
PokerStars Hand #197157552530:  Hold'em No Limit ($0.01/$0.02 USD) - 2019/02/17 7:15:25 ET
Table 'Coppelia III' 6-max Seat #5 is the button
Seat 1: Ganseku Nagi ($4.18 in chips)
Seat 2: sibir555 ($2.78 in chips)
Seat 3: azx838 ($4.59 in chips)
Seat 4: 19VITALIY86 ($0.47 in chips)
Seat 5: Soranton ($2.74 in chips)
Seat 6: Benzer586 ($1.61 in chips)
Benzer586: posts small blind $0.01
Ganseku Nagi: posts big blind $0.02
*** HOLE CARDS ***
Dealt to Benzer586 [4h Ts]
sibir555: folds
azx838: folds
19VITALIY86: folds
Soranton: folds
Benzer586: folds
Uncalled bet ($0.01) returned to Ganseku Nagi
Ganseku Nagi collected $0.02 from pot
Ganseku Nagi: doesn't show hand
*** SUMMARY ***
Total pot $0.02 | Rake $0
Seat 1: Ganseku Nagi (big blind) collected ($0.02)
Seat 2: sibir555 folded before Flop (didn't bet)
Seat 3: azx838 folded before Flop (didn't bet)
Seat 4: 19VITALIY86 folded before Flop (didn't bet)
Seat 5: Soranton (button) folded before Flop (didn't bet)
Seat 6: Benzer586 (small blind) folded before Flop


*********** # 73 **************
PokerStars Hand #197157540733:  Hold'em No Limit ($0.01/$0.02 USD) - 2019/02/17 7:14:59 ET
Table 'Coppelia III' 6-max Seat #4 is the button
Seat 1: Ganseku Nagi ($4.18 in chips)
Seat 2: sibir555 ($2.78 in chips)
Seat 3: azx838 ($4.59 in chips)
Seat 4: 19VITALIY86 ($0.49 in chips)
Seat 5: Soranton ($2.70 in chips)
Seat 6: Benzer586 ($1.63 in chips)
Soranton: posts small blind $0.01
Benzer586: posts big blind $0.02
*** HOLE CARDS ***
Dealt to Benzer586 [5s 4c]
Ganseku Nagi: folds
sibir555: folds
azx838: folds
19VITALIY86: calls $0.02
Soranton: calls $0.01
Benzer586: checks
*** FLOP *** [7h 7s Th]
Soranton: checks
Benzer586: checks
19VITALIY86: checks
*** TURN *** [7h 7s Th] [As]
Soranton: bets $0.02
Benzer586: folds
19VITALIY86: folds
Uncalled bet ($0.02) returned to Soranton
Soranton collected $0.06 from pot
Soranton: doesn't show hand
*** SUMMARY ***
Total pot $0.06 | Rake $0
Board [7h 7s Th As]
Seat 1: Ganseku Nagi folded before Flop (didn't bet)
Seat 2: sibir555 folded before Flop (didn't bet)
Seat 3: azx838 folded before Flop (didn't bet)
Seat 4: 19VITALIY86 (button) folded on the Turn
Seat 5: Soranton (small blind) collected ($0.06)
Seat 6: Benzer586 (big blind) folded on the Turn


*********** # 74 **************
PokerStars Hand #197157533769:  Hold'em No Limit ($0.01/$0.02 USD) - 2019/02/17 7:14:44 ET
Table 'Coppelia III' 6-max Seat #3 is the button
Seat 1: Ganseku Nagi ($4.15 in chips)
Seat 2: sibir555 ($2.78 in chips)
Seat 3: azx838 ($4.59 in chips)
Seat 4: 19VITALIY86 ($0.50 in chips)
Seat 5: Soranton ($2.72 in chips)
Seat 6: Benzer586 ($1.63 in chips)
19VITALIY86: posts small blind $0.01
Soranton: posts big blind $0.02
*** HOLE CARDS ***
Dealt to Benzer586 [9d Ah]
Benzer586: folds
Ganseku Nagi: raises $0.04 to $0.06
sibir555: folds
azx838: folds
19VITALIY86: folds
Soranton: folds
Uncalled bet ($0.04) returned to Ganseku Nagi
Ganseku Nagi collected $0.05 from pot
Ganseku Nagi: doesn't show hand
*** SUMMARY ***
Total pot $0.05 | Rake $0
Seat 1: Ganseku Nagi collected ($0.05)
Seat 2: sibir555 folded before Flop (didn't bet)
Seat 3: azx838 (button) folded before Flop (didn't bet)
Seat 4: 19VITALIY86 (small blind) folded before Flop
Seat 5: Soranton (big blind) folded before Flop
Seat 6: Benzer586 folded before Flop (didn't bet)


*********** # 75 **************
PokerStars Hand #197157510579:  Hold'em No Limit ($0.01/$0.02 USD) - 2019/02/17 7:13:53 ET
Table 'Coppelia III' 6-max Seat #2 is the button
Seat 1: Ganseku Nagi ($4.21 in chips)
Seat 2: sibir555 ($2.78 in chips)
Seat 3: azx838 ($4.60 in chips)
Seat 4: 19VITALIY86 ($1.31 in chips)
Seat 5: Soranton ($2.72 in chips)
Seat 6: Benzer586 ($0.81 in chips)
azx838: posts small blind $0.01
19VITALIY86: posts big blind $0.02
*** HOLE CARDS ***
Dealt to Benzer586 [Kc Kd]
Soranton: folds
Benzer586: raises $0.02 to $0.04
Ganseku Nagi: calls $0.04
sibir555: folds
azx838: folds
19VITALIY86: raises $0.02 to $0.06
Benzer586: calls $0.02
Ganseku Nagi: calls $0.02
*** FLOP *** [7c 5c 3h]
19VITALIY86: bets $0.18
Benzer586: raises $0.18 to $0.36
Ganseku Nagi: folds
19VITALIY86: raises $0.89 to $1.25 and is all-in
Benzer586: calls $0.39 and is all-in
Uncalled bet ($0.50) returned to 19VITALIY86
*** TURN *** [7c 5c 3h] [Kh]
*** RIVER *** [7c 5c 3h Kh] [Ts]
*** SHOW DOWN ***
19VITALIY86: shows [Jd Jc] (a pair of Jacks)
Benzer586: shows [Kc Kd] (three of a kind, Kings)
Benzer586 collected $1.63 from pot
*** SUMMARY ***
Total pot $1.69 | Rake $0.06
Board [7c 5c 3h Kh Ts]
Seat 1: Ganseku Nagi folded on the Flop
Seat 2: sibir555 (button) folded before Flop (didn't bet)
Seat 3: azx838 (small blind) folded before Flop
Seat 4: 19VITALIY86 (big blind) showed [Jd Jc] and lost with a pair of Jacks
Seat 5: Soranton folded before Flop (didn't bet)
Seat 6: Benzer586 showed [Kc Kd] and won ($1.63) with three of a kind, Kings


*********** # 76 **************
PokerStars Hand #197157500715:  Hold'em No Limit ($0.01/$0.02 USD) - 2019/02/17 7:13:31 ET
Table 'Coppelia III' 6-max Seat #1 is the button
Seat 1: Ganseku Nagi ($4.16 in chips)
Seat 2: sibir555 ($2.79 in chips)
Seat 3: azx838 ($4.64 in chips)
Seat 4: 19VITALIY86 ($1.31 in chips)
Seat 5: Soranton ($2.72 in chips)
Seat 6: Benzer586 ($0.81 in chips)
sibir555: posts small blind $0.01
azx838: posts big blind $0.02
*** HOLE CARDS ***
Dealt to Benzer586 [2s 6s]
19VITALIY86: folds
Soranton: folds
Benzer586: folds
Ganseku Nagi: raises $0.02 to $0.04
sibir555: folds
azx838: calls $0.02
*** FLOP *** [Td Kd 7d]
azx838: checks
Ganseku Nagi: bets $0.06
azx838: folds
Uncalled bet ($0.06) returned to Ganseku Nagi
Ganseku Nagi collected $0.09 from pot
Ganseku Nagi: doesn't show hand
*** SUMMARY ***
Total pot $0.09 | Rake $0
Board [Td Kd 7d]
Seat 1: Ganseku Nagi (button) collected ($0.09)
Seat 2: sibir555 (small blind) folded before Flop
Seat 3: azx838 (big blind) folded on the Flop
Seat 4: 19VITALIY86 folded before Flop (didn't bet)
Seat 5: Soranton folded before Flop (didn't bet)
Seat 6: Benzer586 folded before Flop (didn't bet)


*********** # 77 **************
PokerStars Hand #197157485823:  Hold'em No Limit ($0.01/$0.02 USD) - 2019/02/17 7:12:58 ET
Table 'Coppelia III' 6-max Seat #6 is the button
Seat 1: Ganseku Nagi ($4.17 in chips)
Seat 2: sibir555 ($2.73 in chips)
Seat 3: azx838 ($4.64 in chips)
Seat 4: 19VITALIY86 ($1.36 in chips)
Seat 5: Soranton ($2.72 in chips)
Seat 6: Benzer586 ($0.81 in chips)
Ganseku Nagi: posts small blind $0.01
sibir555: posts big blind $0.02
*** HOLE CARDS ***
Dealt to Benzer586 [9d 4s]
azx838: folds
19VITALIY86: calls $0.02
Soranton: folds
Benzer586: folds
Ganseku Nagi: folds
sibir555: checks
*** FLOP *** [3c 5d Qh]
sibir555: checks
19VITALIY86: bets $0.03
sibir555: calls $0.03
*** TURN *** [3c 5d Qh] [2c]
sibir555: bets $2.68 and is all-in
19VITALIY86: folds
Uncalled bet ($2.68) returned to sibir555
sibir555 collected $0.11 from pot
*** SUMMARY ***
Total pot $0.11 | Rake $0
Board [3c 5d Qh 2c]
Seat 1: Ganseku Nagi (small blind) folded before Flop
Seat 2: sibir555 (big blind) collected ($0.11)
Seat 3: azx838 folded before Flop (didn't bet)
Seat 4: 19VITALIY86 folded on the Turn
Seat 5: Soranton folded before Flop (didn't bet)
Seat 6: Benzer586 (button) folded before Flop (didn't bet)


*********** # 78 **************
PokerStars Hand #197157473293:  Hold'em No Limit ($0.01/$0.02 USD) - 2019/02/17 7:12:30 ET
Table 'Coppelia III' 6-max Seat #5 is the button
Seat 1: Ganseku Nagi ($4.11 in chips)
Seat 2: sibir555 ($2.73 in chips)
Seat 3: azx838 ($4.64 in chips)
Seat 4: 19VITALIY86 ($1.36 in chips)
Seat 5: Soranton ($2.72 in chips)
Seat 6: Benzer586 ($0.87 in chips)
Benzer586: posts small blind $0.01
Ganseku Nagi: posts big blind $0.02
*** HOLE CARDS ***
Dealt to Benzer586 [8h 7h]
sibir555: folds
azx838: folds
19VITALIY86: folds
Soranton: folds
Benzer586: calls $0.01
Ganseku Nagi: raises $0.04 to $0.06
Benzer586: calls $0.04
*** FLOP *** [Kd Tc Js]
Benzer586: checks
Ganseku Nagi: bets $0.08
Benzer586: folds
Uncalled bet ($0.08) returned to Ganseku Nagi
Ganseku Nagi collected $0.12 from pot
Ganseku Nagi: doesn't show hand
*** SUMMARY ***
Total pot $0.12 | Rake $0
Board [Kd Tc Js]
Seat 1: Ganseku Nagi (big blind) collected ($0.12)
Seat 2: sibir555 folded before Flop (didn't bet)
Seat 3: azx838 folded before Flop (didn't bet)
Seat 4: 19VITALIY86 folded before Flop (didn't bet)
Seat 5: Soranton (button) folded before Flop (didn't bet)
Seat 6: Benzer586 (small blind) folded on the Flop


*********** # 79 **************
PokerStars Hand #197157469315:  Hold'em No Limit ($0.01/$0.02 USD) - 2019/02/17 7:12:21 ET
Table 'Coppelia III' 6-max Seat #4 is the button
Seat 1: Ganseku Nagi ($4.11 in chips)
Seat 2: sibir555 ($2.73 in chips)
Seat 3: azx838 ($4.64 in chips)
Seat 4: 19VITALIY86 ($1.36 in chips)
Seat 5: Soranton ($2.73 in chips)
Seat 6: Benzer586 ($0.86 in chips)
Soranton: posts small blind $0.01
Benzer586: posts big blind $0.02
*** HOLE CARDS ***
Dealt to Benzer586 [Js Ad]
Ganseku Nagi: folds
sibir555: folds
azx838: folds
19VITALIY86: folds
Soranton: folds
Uncalled bet ($0.01) returned to Benzer586
Benzer586 collected $0.02 from pot
Benzer586: doesn't show hand
*** SUMMARY ***
Total pot $0.02 | Rake $0
Seat 1: Ganseku Nagi folded before Flop (didn't bet)
Seat 2: sibir555 folded before Flop (didn't bet)
Seat 3: azx838 folded before Flop (didn't bet)
Seat 4: 19VITALIY86 (button) folded before Flop (didn't bet)
Seat 5: Soranton (small blind) folded before Flop
Seat 6: Benzer586 (big blind) collected ($0.02)


*********** # 80 **************
PokerStars Hand #197157458557:  Hold'em No Limit ($0.01/$0.02 USD) - 2019/02/17 7:11:57 ET
Table 'Coppelia III' 6-max Seat #3 is the button
Seat 1: Ganseku Nagi ($4.11 in chips)
Seat 2: sibir555 ($2.73 in chips)
Seat 3: azx838 ($4.64 in chips)
Seat 4: 19VITALIY86 ($1.38 in chips)
Seat 5: Soranton ($2.71 in chips)
Seat 6: Benzer586 ($0.86 in chips)
19VITALIY86: posts small blind $0.01
Soranton: posts big blind $0.02
*** HOLE CARDS ***
Dealt to Benzer586 [3s Ac]
Benzer586: folds
Ganseku Nagi: folds
sibir555: folds
azx838: folds
19VITALIY86: calls $0.01
Soranton: checks
*** FLOP *** [6h 2h Ad]
19VITALIY86: checks
Soranton: checks
*** TURN *** [6h 2h Ad] [4s]
19VITALIY86: checks
Soranton: bets $0.02
19VITALIY86: folds
Uncalled bet ($0.02) returned to Soranton
Soranton collected $0.04 from pot
Soranton: doesn't show hand
*** SUMMARY ***
Total pot $0.04 | Rake $0
Board [6h 2h Ad 4s]
Seat 1: Ganseku Nagi folded before Flop (didn't bet)
Seat 2: sibir555 folded before Flop (didn't bet)
Seat 3: azx838 (button) folded before Flop (didn't bet)
Seat 4: 19VITALIY86 (small blind) folded on the Turn
Seat 5: Soranton (big blind) collected ($0.04)
Seat 6: Benzer586 folded before Flop (didn't bet)


*********** # 81 **************
PokerStars Hand #197157442988:  Hold'em No Limit ($0.01/$0.02 USD) - 2019/02/17 7:11:22 ET
Table 'Coppelia III' 6-max Seat #2 is the button
Seat 1: Ganseku Nagi ($4.11 in chips)
Seat 2: sibir555 ($2.73 in chips)
Seat 3: azx838 ($4.23 in chips)
Seat 4: 19VITALIY86 ($1.82 in chips)
Seat 5: Soranton ($2.71 in chips)
Seat 6: Benzer586 ($0.86 in chips)
azx838: posts small blind $0.01
19VITALIY86: posts big blind $0.02
*** HOLE CARDS ***
Dealt to Benzer586 [Jc 2d]
Soranton: folds
Benzer586: folds
Ganseku Nagi: folds
sibir555: folds
azx838: raises $0.04 to $0.06
19VITALIY86: calls $0.04
*** FLOP *** [Qc 4d 8s]
azx838: bets $0.06
19VITALIY86: calls $0.06
*** TURN *** [Qc 4d 8s] [6s]
azx838: bets $0.08
19VITALIY86: calls $0.08
*** RIVER *** [Qc 4d 8s 6s] [8d]
azx838: bets $0.24
19VITALIY86: calls $0.24
*** SHOW DOWN ***
azx838: shows [7c 8c] (three of a kind, Eights)
19VITALIY86: mucks hand
azx838 collected $0.85 from pot
*** SUMMARY ***
Total pot $0.88 | Rake $0.03
Board [Qc 4d 8s 6s 8d]
Seat 1: Ganseku Nagi folded before Flop (didn't bet)
Seat 2: sibir555 (button) folded before Flop (didn't bet)
Seat 3: azx838 (small blind) showed [7c 8c] and won ($0.85) with three of a kind, Eights
Seat 4: 19VITALIY86 (big blind) mucked [9s Qh]
Seat 5: Soranton folded before Flop (didn't bet)
Seat 6: Benzer586 folded before Flop (didn't bet)


*********** # 82 **************
PokerStars Hand #197157421807:  Hold'em No Limit ($0.01/$0.02 USD) - 2019/02/17 7:10:35 ET
Table 'Coppelia III' 6-max Seat #1 is the button
Seat 1: Ganseku Nagi ($4.11 in chips)
Seat 2: sibir555 ($2.74 in chips)
Seat 3: azx838 ($4.25 in chips)
Seat 4: 19VITALIY86 ($1.79 in chips)
Seat 5: Soranton ($2.71 in chips)
Seat 6: Benzer586 ($0.86 in chips)
sibir555: posts small blind $0.01
azx838: posts big blind $0.02
*** HOLE CARDS ***
Dealt to Benzer586 [7d 3s]
19VITALIY86: calls $0.02
Soranton: folds
Benzer586: folds
Ganseku Nagi: folds
sibir555: folds
azx838: checks
*** FLOP *** [3c 8h Ts]
azx838: checks
19VITALIY86: checks
*** TURN *** [3c 8h Ts] [Tc]
azx838: checks
19VITALIY86: bets $0.02
azx838: folds
Uncalled bet ($0.02) returned to 19VITALIY86
19VITALIY86 collected $0.05 from pot
*** SUMMARY ***
Total pot $0.05 | Rake $0
Board [3c 8h Ts Tc]
Seat 1: Ganseku Nagi (button) folded before Flop (didn't bet)
Seat 2: sibir555 (small blind) folded before Flop
Seat 3: azx838 (big blind) folded on the Turn
Seat 4: 19VITALIY86 collected ($0.05)
Seat 5: Soranton folded before Flop (didn't bet)
Seat 6: Benzer586 folded before Flop (didn't bet)


*********** # 83 **************
PokerStars Hand #197157398434:  Hold'em No Limit ($0.01/$0.02 USD) - 2019/02/17 7:09:43 ET
Table 'Coppelia III' 6-max Seat #6 is the button
Seat 1: Ganseku Nagi ($6.17 in chips)
Seat 2: sibir555 ($2.76 in chips)
Seat 3: azx838 ($2.06 in chips)
Seat 4: 19VITALIY86 ($2.05 in chips)
Seat 5: Soranton ($2.71 in chips)
Seat 6: Benzer586 ($0.86 in chips)
Ganseku Nagi: posts small blind $0.01
sibir555: posts big blind $0.02
*** HOLE CARDS ***
Dealt to Benzer586 [7h Ad]
azx838: raises $0.04 to $0.06
19VITALIY86: calls $0.06
Soranton: folds
Benzer586: folds
Ganseku Nagi: raises $0.20 to $0.26
sibir555: folds
azx838: calls $0.20
19VITALIY86: calls $0.20
*** FLOP *** [2h 8c 5h]
Ganseku Nagi: bets $0.40
azx838: raises $0.40 to $0.80
19VITALIY86: folds
Ganseku Nagi: calls $0.40
*** TURN *** [2h 8c 5h] [9s]
Ganseku Nagi: checks
azx838: bets $1 and is all-in
Ganseku Nagi: calls $1
*** RIVER *** [2h 8c 5h 9s] [6d]
*** SHOW DOWN ***
Ganseku Nagi: shows [Js Jd] (a pair of Jacks)
azx838: shows [9h 9c] (three of a kind, Nines)
azx838 collected $4.25 from pot
*** SUMMARY ***
Total pot $4.40 | Rake $0.15
Board [2h 8c 5h 9s 6d]
Seat 1: Ganseku Nagi (small blind) showed [Js Jd] and lost with a pair of Jacks
Seat 2: sibir555 (big blind) folded before Flop
Seat 3: azx838 showed [9h 9c] and won ($4.25) with three of a kind, Nines
Seat 4: 19VITALIY86 folded on the Flop
Seat 5: Soranton folded before Flop (didn't bet)
Seat 6: Benzer586 (button) folded before Flop (didn't bet)


*********** # 84 **************
PokerStars Hand #197157388772:  Hold'em No Limit ($0.01/$0.02 USD) - 2019/02/17 7:09:22 ET
Table 'Coppelia III' 6-max Seat #5 is the button
Seat 1: Ganseku Nagi ($6.19 in chips)
Seat 2: sibir555 ($2.73 in chips)
Seat 3: azx838 ($2.06 in chips)
Seat 4: 19VITALIY86 ($2.05 in chips)
Seat 5: Soranton ($2.71 in chips)
Seat 6: Benzer586 ($0.87 in chips)
Benzer586: posts small blind $0.01
Ganseku Nagi: posts big blind $0.02
*** HOLE CARDS ***
Dealt to Benzer586 [Kd 7d]
sibir555: raises $0.03 to $0.05
azx838: folds
19VITALIY86: folds
Soranton: folds
Benzer586: folds
Ganseku Nagi: folds
Uncalled bet ($0.03) returned to sibir555
sibir555 collected $0.05 from pot
*** SUMMARY ***
Total pot $0.05 | Rake $0
Seat 1: Ganseku Nagi (big blind) folded before Flop
Seat 2: sibir555 collected ($0.05)
Seat 3: azx838 folded before Flop (didn't bet)
Seat 4: 19VITALIY86 folded before Flop (didn't bet)
Seat 5: Soranton (button) folded before Flop (didn't bet)
Seat 6: Benzer586 (small blind) folded before Flop


*********** # 85 **************
PokerStars Hand #197157381869:  Hold'em No Limit ($0.01/$0.02 USD) - 2019/02/17 7:09:07 ET
Table 'Coppelia III' 6-max Seat #4 is the button
Seat 1: Ganseku Nagi ($6.19 in chips)
Seat 2: sibir555 ($2.70 in chips)
Seat 3: azx838 ($2.06 in chips)
Seat 4: 19VITALIY86 ($2.05 in chips)
Seat 5: Soranton ($2.72 in chips)
Seat 6: Benzer586 ($0.89 in chips)
Soranton: posts small blind $0.01
Benzer586: posts big blind $0.02
*** HOLE CARDS ***
Dealt to Benzer586 [Tc 2h]
Ganseku Nagi: folds
sibir555: raises $0.03 to $0.05
azx838: folds
19VITALIY86: folds
Soranton: folds
Benzer586: folds
Uncalled bet ($0.03) returned to sibir555
sibir555 collected $0.05 from pot
*** SUMMARY ***
Total pot $0.05 | Rake $0
Seat 1: Ganseku Nagi folded before Flop (didn't bet)
Seat 2: sibir555 collected ($0.05)
Seat 3: azx838 folded before Flop (didn't bet)
Seat 4: 19VITALIY86 (button) folded before Flop (didn't bet)
Seat 5: Soranton (small blind) folded before Flop
Seat 6: Benzer586 (big blind) folded before Flop


*********** # 86 **************
PokerStars Hand #197157371348:  Hold'em No Limit ($0.01/$0.02 USD) - 2019/02/17 7:08:44 ET
Table 'Coppelia III' 6-max Seat #3 is the button
Seat 1: Ganseku Nagi ($6.19 in chips)
Seat 2: sibir555 ($2.70 in chips)
Seat 3: azx838 ($2.06 in chips)
Seat 4: 19VITALIY86 ($2.07 in chips)
Seat 5: Soranton ($2.70 in chips)
Seat 6: Benzer586 ($0.89 in chips)
19VITALIY86: posts small blind $0.01
Soranton: posts big blind $0.02
*** HOLE CARDS ***
Dealt to Benzer586 [6h Jh]
Benzer586: folds
Ganseku Nagi: folds
sibir555: folds
azx838: folds
19VITALIY86: calls $0.01
Soranton: checks
*** FLOP *** [2d Qd 6d]
19VITALIY86: checks
Soranton: bets $0.04
19VITALIY86: folds
Uncalled bet ($0.04) returned to Soranton
Soranton collected $0.04 from pot
Soranton: doesn't show hand
*** SUMMARY ***
Total pot $0.04 | Rake $0
Board [2d Qd 6d]
Seat 1: Ganseku Nagi folded before Flop (didn't bet)
Seat 2: sibir555 folded before Flop (didn't bet)
Seat 3: azx838 (button) folded before Flop (didn't bet)
Seat 4: 19VITALIY86 (small blind) folded on the Flop
Seat 5: Soranton (big blind) collected ($0.04)
Seat 6: Benzer586 folded before Flop (didn't bet)


*********** # 87 **************
PokerStars Hand #197157356212:  Hold'em No Limit ($0.01/$0.02 USD) - 2019/02/17 7:08:10 ET
Table 'Coppelia III' 6-max Seat #2 is the button
Seat 1: Ganseku Nagi ($6.19 in chips)
Seat 2: sibir555 ($2.74 in chips)
Seat 3: azx838 ($2 in chips)
Seat 4: 19VITALIY86 ($2.09 in chips)
Seat 5: Soranton ($2.70 in chips)
Seat 6: Benzer586 ($0.89 in chips)
azx838: posts small blind $0.01
19VITALIY86: posts big blind $0.02
*** HOLE CARDS ***
Dealt to Benzer586 [9d Ks]
Soranton: folds
Benzer586: folds
Ganseku Nagi: folds
sibir555: raises $0.02 to $0.04
azx838: calls $0.03
19VITALIY86: folds
*** FLOP *** [Qc 4c 9c]
azx838: checks
sibir555: checks
*** TURN *** [Qc 4c 9c] [4d]
azx838: bets $0.10
sibir555: folds
Uncalled bet ($0.10) returned to azx838
azx838 collected $0.10 from pot
*** SUMMARY ***
Total pot $0.10 | Rake $0
Board [Qc 4c 9c 4d]
Seat 1: Ganseku Nagi folded before Flop (didn't bet)
Seat 2: sibir555 (button) folded on the Turn
Seat 3: azx838 (small blind) collected ($0.10)
Seat 4: 19VITALIY86 (big blind) folded before Flop
Seat 5: Soranton folded before Flop (didn't bet)
Seat 6: Benzer586 folded before Flop (didn't bet)


*********** # 88 **************
PokerStars Hand #197157333207:  Hold'em No Limit ($0.01/$0.02 USD) - 2019/02/17 7:07:18 ET
Table 'Coppelia III' 6-max Seat #1 is the button
Seat 1: Ganseku Nagi ($5.32 in chips)
Seat 2: sibir555 ($2.75 in chips)
Seat 3: azx838 ($2 in chips)
Seat 4: 19VITALIY86 ($2.09 in chips)
Seat 5: Soranton ($2.70 in chips)
Seat 6: Benzer586 ($0.89 in chips)
sibir555: posts small blind $0.01
azx838: posts big blind $0.02
*** HOLE CARDS ***
Dealt to Benzer586 [Kh 8s]
19VITALIY86: folds
Soranton: folds
Benzer586: folds
Ganseku Nagi: raises $0.02 to $0.04
sibir555: folds
azx838: raises $0.14 to $0.18
Ganseku Nagi: calls $0.14
*** FLOP *** [Jd Qd 7c]
azx838: bets $0.24
Ganseku Nagi: calls $0.24
*** TURN *** [Jd Qd 7c] [7d]
azx838: checks
Ganseku Nagi: bets $0.50
azx838: calls $0.50
*** RIVER *** [Jd Qd 7c 7d] [8c]
azx838: checks
Ganseku Nagi: bets $1.79
azx838: folds
Uncalled bet ($1.79) returned to Ganseku Nagi
Ganseku Nagi collected $1.79 from pot
Ganseku Nagi: doesn't show hand
*** SUMMARY ***
Total pot $1.85 | Rake $0.06
Board [Jd Qd 7c 7d 8c]
Seat 1: Ganseku Nagi (button) collected ($1.79)
Seat 2: sibir555 (small blind) folded before Flop
Seat 3: azx838 (big blind) folded on the River
Seat 4: 19VITALIY86 folded before Flop (didn't bet)
Seat 5: Soranton folded before Flop (didn't bet)
Seat 6: Benzer586 folded before Flop (didn't bet)


*********** # 89 **************
PokerStars Hand #197157321942:  Hold'em No Limit ($0.01/$0.02 USD) - 2019/02/17 7:06:53 ET
Table 'Coppelia III' 6-max Seat #6 is the button
Seat 1: Ganseku Nagi ($5.30 in chips)
Seat 2: sibir555 ($2.77 in chips)
Seat 3: azx838 ($2 in chips)
Seat 4: 19VITALIY86 ($2.09 in chips)
Seat 5: Soranton ($2.70 in chips)
Seat 6: Benzer586 ($0.89 in chips)
Ganseku Nagi: posts small blind $0.01
sibir555: posts big blind $0.02
*** HOLE CARDS ***
Dealt to Benzer586 [Kh Th]
azx838: folds
19VITALIY86: folds
Soranton: folds
Benzer586: folds
Ganseku Nagi: raises $0.04 to $0.06
sibir555: folds
Uncalled bet ($0.04) returned to Ganseku Nagi
Ganseku Nagi collected $0.04 from pot
Ganseku Nagi: doesn't show hand
*** SUMMARY ***
Total pot $0.04 | Rake $0
Seat 1: Ganseku Nagi (small blind) collected ($0.04)
Seat 2: sibir555 (big blind) folded before Flop
Seat 3: azx838 folded before Flop (didn't bet)
Seat 4: 19VITALIY86 folded before Flop (didn't bet)
Seat 5: Soranton folded before Flop (didn't bet)
Seat 6: Benzer586 (button) folded before Flop (didn't bet)


*********** # 90 **************
PokerStars Hand #197157309648:  Hold'em No Limit ($0.01/$0.02 USD) - 2019/02/17 7:06:25 ET
Table 'Coppelia III' 6-max Seat #5 is the button
Seat 1: Ganseku Nagi ($5.32 in chips)
Seat 2: sibir555 ($2.77 in chips)
Seat 3: azx838 ($2 in chips)
Seat 4: 19VITALIY86 ($2.17 in chips)
Seat 5: Soranton ($2.60 in chips)
Seat 6: Benzer586 ($0.90 in chips)
Benzer586: posts small blind $0.01
Ganseku Nagi: posts big blind $0.02
*** HOLE CARDS ***
Dealt to Benzer586 [5h Tc]
sibir555: folds
azx838: folds
19VITALIY86: calls $0.02
Soranton: raises $0.06 to $0.08
Benzer586: folds
Ganseku Nagi: folds
19VITALIY86: calls $0.06
*** FLOP *** [2h Jd Jh]
19VITALIY86: checks
Soranton: bets $0.09
19VITALIY86: folds
Uncalled bet ($0.09) returned to Soranton
Soranton collected $0.18 from pot
Soranton: doesn't show hand
*** SUMMARY ***
Total pot $0.19 | Rake $0.01
Board [2h Jd Jh]
Seat 1: Ganseku Nagi (big blind) folded before Flop
Seat 2: sibir555 folded before Flop (didn't bet)
Seat 3: azx838 folded before Flop (didn't bet)
Seat 4: 19VITALIY86 folded on the Flop
Seat 5: Soranton (button) collected ($0.18)
Seat 6: Benzer586 (small blind) folded before Flop


*********** # 91 **************
PokerStars Hand #197157281318:  Hold'em No Limit ($0.01/$0.02 USD) - 2019/02/17 7:05:22 ET
Table 'Coppelia III' 6-max Seat #4 is the button
Seat 1: Ganseku Nagi ($4.79 in chips)
Seat 2: sibir555 ($2.77 in chips)
Seat 3: azx838 ($2.01 in chips)
Seat 4: 19VITALIY86 ($2.17 in chips)
Seat 5: Soranton ($2.61 in chips)
Seat 6: Benzer586 ($0.92 in chips)
Soranton: posts small blind $0.01
Benzer586: posts big blind $0.02
*** HOLE CARDS ***
Dealt to Benzer586 [Qc 2s]
Ganseku Nagi: raises $0.04 to $0.06
sibir555: folds
azx838: calls $0.06
19VITALIY86: folds
Soranton: folds
Benzer586: folds
*** FLOP *** [9c 5h Kh]
Ganseku Nagi: bets $0.08
azx838: calls $0.08
*** TURN *** [9c 5h Kh] [Qd]
Ganseku Nagi: bets $0.15
azx838: raises $0.25 to $0.40
Ganseku Nagi: raises $0.60 to $1
azx838: folds
Uncalled bet ($0.60) returned to Ganseku Nagi
Ganseku Nagi collected $1.07 from pot
Ganseku Nagi: doesn't show hand
*** SUMMARY ***
Total pot $1.11 | Rake $0.04
Board [9c 5h Kh Qd]
Seat 1: Ganseku Nagi collected ($1.07)
Seat 2: sibir555 folded before Flop (didn't bet)
Seat 3: azx838 folded on the Turn
Seat 4: 19VITALIY86 (button) folded before Flop (didn't bet)
Seat 5: Soranton (small blind) folded before Flop
Seat 6: Benzer586 (big blind) folded before Flop


*********** # 92 **************
PokerStars Hand #197157269416:  Hold'em No Limit ($0.01/$0.02 USD) - 2019/02/17 7:04:56 ET
Table 'Coppelia III' 6-max Seat #3 is the button
Seat 1: Ganseku Nagi ($4.79 in chips)
Seat 2: sibir555 ($2.74 in chips)
Seat 3: azx838 ($2.01 in chips)
Seat 4: 19VITALIY86 ($2.18 in chips)
Seat 5: Soranton ($2.63 in chips)
Seat 6: Benzer586 ($0.92 in chips)
19VITALIY86: posts small blind $0.01
Soranton: posts big blind $0.02
*** HOLE CARDS ***
Dealt to Benzer586 [5c Ac]
Benzer586: folds
Ganseku Nagi: folds
sibir555: raises $0.03 to $0.05
azx838: folds
19VITALIY86: folds
Soranton: folds
Uncalled bet ($0.03) returned to sibir555
sibir555 collected $0.05 from pot
*** SUMMARY ***
Total pot $0.05 | Rake $0
Seat 1: Ganseku Nagi folded before Flop (didn't bet)
Seat 2: sibir555 collected ($0.05)
Seat 3: azx838 (button) folded before Flop (didn't bet)
Seat 4: 19VITALIY86 (small blind) folded before Flop
Seat 5: Soranton (big blind) folded before Flop
Seat 6: Benzer586 folded before Flop (didn't bet)


*********** # 93 **************
PokerStars Hand #197157264391:  Hold'em No Limit ($0.01/$0.02 USD) - 2019/02/17 7:04:45 ET
Table 'Coppelia III' 6-max Seat #2 is the button
Seat 1: Ganseku Nagi ($4.79 in chips)
Seat 2: sibir555 ($2.74 in chips)
Seat 3: azx838 ($2.02 in chips)
Seat 4: 19VITALIY86 ($2.17 in chips)
Seat 5: Soranton ($2.63 in chips)
Seat 6: Benzer586 ($0.92 in chips)
azx838: posts small blind $0.01
19VITALIY86: posts big blind $0.02
*** HOLE CARDS ***
Dealt to Benzer586 [8s 7d]
Soranton: folds
Benzer586: folds
Ganseku Nagi: folds
sibir555: folds
azx838: folds
Uncalled bet ($0.01) returned to 19VITALIY86
19VITALIY86 collected $0.02 from pot
*** SUMMARY ***
Total pot $0.02 | Rake $0
Seat 1: Ganseku Nagi folded before Flop (didn't bet)
Seat 2: sibir555 (button) folded before Flop (didn't bet)
Seat 3: azx838 (small blind) folded before Flop
Seat 4: 19VITALIY86 (big blind) collected ($0.02)
Seat 5: Soranton folded before Flop (didn't bet)
Seat 6: Benzer586 folded before Flop (didn't bet)


*********** # 94 **************
PokerStars Hand #197157254411:  Hold'em No Limit ($0.01/$0.02 USD) - 2019/02/17 7:04:22 ET
Table 'Coppelia III' 6-max Seat #1 is the button
Seat 1: Ganseku Nagi ($4.79 in chips)
Seat 2: sibir555 ($2.75 in chips)
Seat 3: azx838 ($2.04 in chips)
Seat 4: 19VITALIY86 ($2.14 in chips)
Seat 5: Soranton ($2.63 in chips)
Seat 6: Benzer586 ($0.92 in chips)
sibir555: posts small blind $0.01
azx838: posts big blind $0.02
*** HOLE CARDS ***
Dealt to Benzer586 [4h Jd]
19VITALIY86: calls $0.02
Soranton: folds
Benzer586: folds
Ganseku Nagi: folds
sibir555: folds
azx838: checks
*** FLOP *** [As Qh 3s]
azx838: checks
19VITALIY86: bets $0.04
azx838: folds
Uncalled bet ($0.04) returned to 19VITALIY86
19VITALIY86 collected $0.05 from pot
*** SUMMARY ***
Total pot $0.05 | Rake $0
Board [As Qh 3s]
Seat 1: Ganseku Nagi (button) folded before Flop (didn't bet)
Seat 2: sibir555 (small blind) folded before Flop
Seat 3: azx838 (big blind) folded on the Flop
Seat 4: 19VITALIY86 collected ($0.05)
Seat 5: Soranton folded before Flop (didn't bet)
Seat 6: Benzer586 folded before Flop (didn't bet)


*********** # 95 **************
PokerStars Hand #197157243849:  Hold'em No Limit ($0.01/$0.02 USD) - 2019/02/17 7:03:58 ET
Table 'Coppelia III' 6-max Seat #6 is the button
Seat 1: Ganseku Nagi ($4.80 in chips)
Seat 2: sibir555 ($2.77 in chips)
Seat 3: azx838 ($2.10 in chips)
Seat 4: 19VITALIY86 ($2.20 in chips)
Seat 5: Soranton ($2.48 in chips)
Seat 6: Benzer586 ($0.92 in chips)
Ganseku Nagi: posts small blind $0.01
sibir555: posts big blind $0.02
*** HOLE CARDS ***
Dealt to Benzer586 [Qs 6s]
azx838: raises $0.04 to $0.06
19VITALIY86: calls $0.06
Soranton: raises $0.20 to $0.26
Benzer586: folds
Ganseku Nagi: folds
sibir555: folds
azx838: folds
19VITALIY86: folds
Uncalled bet ($0.20) returned to Soranton
Soranton collected $0.21 from pot
Soranton: doesn't show hand
*** SUMMARY ***
Total pot $0.21 | Rake $0
Seat 1: Ganseku Nagi (small blind) folded before Flop
Seat 2: sibir555 (big blind) folded before Flop
Seat 3: azx838 folded before Flop
Seat 4: 19VITALIY86 folded before Flop
Seat 5: Soranton collected ($0.21)
Seat 6: Benzer586 (button) folded before Flop (didn't bet)


*********** # 96 **************
PokerStars Hand #197157239601:  Hold'em No Limit ($0.01/$0.02 USD) - 2019/02/17 7:03:49 ET
Table 'Coppelia III' 6-max Seat #5 is the button
Seat 1: Ganseku Nagi ($4.79 in chips)
Seat 2: sibir555 ($2.77 in chips)
Seat 3: azx838 ($2.10 in chips)
Seat 4: 19VITALIY86 ($2.20 in chips)
Seat 5: Soranton ($2.48 in chips)
Seat 6: Benzer586 ($0.93 in chips)
Benzer586: posts small blind $0.01
Ganseku Nagi: posts big blind $0.02
*** HOLE CARDS ***
Dealt to Benzer586 [5s Qc]
sibir555: folds
azx838: folds
19VITALIY86: folds
Soranton: folds
Benzer586: folds
Uncalled bet ($0.01) returned to Ganseku Nagi
Ganseku Nagi collected $0.02 from pot
Ganseku Nagi: doesn't show hand
*** SUMMARY ***
Total pot $0.02 | Rake $0
Seat 1: Ganseku Nagi (big blind) collected ($0.02)
Seat 2: sibir555 folded before Flop (didn't bet)
Seat 3: azx838 folded before Flop (didn't bet)
Seat 4: 19VITALIY86 folded before Flop (didn't bet)
Seat 5: Soranton (button) folded before Flop (didn't bet)
Seat 6: Benzer586 (small blind) folded before Flop


*********** # 97 **************
PokerStars Hand #197157224502:  Hold'em No Limit ($0.01/$0.02 USD) - 2019/02/17 7:03:15 ET
Table 'Coppelia III' 6-max Seat #4 is the button
Seat 1: Ganseku Nagi ($4.79 in chips)
Seat 2: sibir555 ($2.99 in chips)
Seat 3: azx838 ($2.10 in chips)
Seat 4: 19VITALIY86 ($2.25 in chips)
Seat 5: Soranton ($2.21 in chips)
Seat 6: Benzer586 ($0.95 in chips)
Soranton: posts small blind $0.01
Benzer586: posts big blind $0.02
*** HOLE CARDS ***
Dealt to Benzer586 [5d Ks]
Ganseku Nagi: folds
sibir555: raises $0.03 to $0.05
azx838: folds
19VITALIY86: calls $0.05
Soranton: raises $0.17 to $0.22
Benzer586: folds
sibir555: calls $0.17
19VITALIY86: folds
*** FLOP *** [8h 8c Qd]
Soranton: bets $0.30
sibir555: folds
Uncalled bet ($0.30) returned to Soranton
Soranton collected $0.49 from pot
Soranton: doesn't show hand
*** SUMMARY ***
Total pot $0.51 | Rake $0.02
Board [8h 8c Qd]
Seat 1: Ganseku Nagi folded before Flop (didn't bet)
Seat 2: sibir555 folded on the Flop
Seat 3: azx838 folded before Flop (didn't bet)
Seat 4: 19VITALIY86 (button) folded before Flop
Seat 5: Soranton (small blind) collected ($0.49)
Seat 6: Benzer586 (big blind) folded before Flop


*********** # 98 **************
PokerStars Hand #197157220119:  Hold'em No Limit ($0.01/$0.02 USD) - 2019/02/17 7:03:05 ET
Table 'Coppelia III' 6-max Seat #3 is the button
Seat 1: Ganseku Nagi ($4.79 in chips)
Seat 2: sibir555 ($2.99 in chips)
Seat 3: azx838 ($2.10 in chips)
Seat 4: 19VITALIY86 ($2.26 in chips)
Seat 5: Soranton ($2.20 in chips)
Seat 6: Benzer586 ($0.95 in chips)
19VITALIY86: posts small blind $0.01
Soranton: posts big blind $0.02
*** HOLE CARDS ***
Dealt to Benzer586 [Qd Jc]
Benzer586: folds
Ganseku Nagi: folds
sibir555: folds
azx838: folds
19VITALIY86: folds
Uncalled bet ($0.01) returned to Soranton
Soranton collected $0.02 from pot
Soranton: doesn't show hand
*** SUMMARY ***
Total pot $0.02 | Rake $0
Seat 1: Ganseku Nagi folded before Flop (didn't bet)
Seat 2: sibir555 folded before Flop (didn't bet)
Seat 3: azx838 (button) folded before Flop (didn't bet)
Seat 4: 19VITALIY86 (small blind) folded before Flop
Seat 5: Soranton (big blind) collected ($0.02)
Seat 6: Benzer586 folded before Flop (didn't bet)


*********** # 99 **************
PokerStars Hand #197157203507:  Hold'em No Limit ($0.01/$0.02 USD) - 2019/02/17 7:02:28 ET
Table 'Coppelia III' 6-max Seat #2 is the button
Seat 1: Ganseku Nagi ($4.79 in chips)
Seat 2: sibir555 ($2.99 in chips)
Seat 3: azx838 ($2.11 in chips)
Seat 4: 19VITALIY86 ($2.28 in chips)
Seat 5: Soranton ($2.20 in chips)
Seat 6: Benzer586 ($0.92 in chips)
azx838: posts small blind $0.01
19VITALIY86: posts big blind $0.02
*** HOLE CARDS ***
Dealt to Benzer586 [5c 5d]
Soranton: folds
Benzer586: calls $0.02
Ganseku Nagi: folds
sibir555: folds
azx838: folds
19VITALIY86: checks
*** FLOP *** [Kd Ac Ks]
19VITALIY86: checks
Benzer586: checks
*** TURN *** [Kd Ac Ks] [5s]
19VITALIY86: checks
Benzer586: bets $0.05
19VITALIY86: folds
Uncalled bet ($0.05) returned to Benzer586
Benzer586 collected $0.05 from pot
Benzer586: doesn't show hand
*** SUMMARY ***
Total pot $0.05 | Rake $0
Board [Kd Ac Ks 5s]
Seat 1: Ganseku Nagi folded before Flop (didn't bet)
Seat 2: sibir555 (button) folded before Flop (didn't bet)
Seat 3: azx838 (small blind) folded before Flop
Seat 4: 19VITALIY86 (big blind) folded on the Turn
Seat 5: Soranton folded before Flop (didn't bet)
Seat 6: Benzer586 collected ($0.05)


*********** # 100 **************
PokerStars Hand #197157191355:  Hold'em No Limit ($0.01/$0.02 USD) - 2019/02/17 7:02:00 ET
Table 'Coppelia III' 6-max Seat #1 is the button
Seat 1: Ganseku Nagi ($4.83 in chips)
Seat 2: sibir555 ($2.93 in chips)
Seat 3: azx838 ($2.13 in chips)
Seat 4: 19VITALIY86 ($2.28 in chips)
Seat 5: Soranton ($2.20 in chips)
Seat 6: Benzer586 ($0.92 in chips)
sibir555: posts small blind $0.01
azx838: posts big blind $0.02
*** HOLE CARDS ***
Dealt to Benzer586 [9d 3h]
19VITALIY86: folds
Soranton: folds
Benzer586: folds
Ganseku Nagi: raises $0.02 to $0.04
sibir555: calls $0.03
azx838: folds
*** FLOP *** [Qh Kd 2d]
sibir555: checks
Ganseku Nagi: checks
*** TURN *** [Qh Kd 2d] [Jc]
sibir555: checks
Ganseku Nagi: checks
*** RIVER *** [Qh Kd 2d Jc] [8c]
sibir555: checks
Ganseku Nagi: checks
*** SHOW DOWN ***
sibir555: shows [Tc Js] (a pair of Jacks)
Ganseku Nagi: mucks hand
sibir555 collected $0.10 from pot
*** SUMMARY ***
Total pot $0.10 | Rake $0
Board [Qh Kd 2d Jc 8c]
Seat 1: Ganseku Nagi (button) mucked [Jh 9c]
Seat 2: sibir555 (small blind) showed [Tc Js] and won ($0.10) with a pair of Jacks
Seat 3: azx838 (big blind) folded before Flop
Seat 4: 19VITALIY86 folded before Flop (didn't bet)
Seat 5: Soranton folded before Flop (didn't bet)
Seat 6: Benzer586 folded before Flop (didn't bet)


PokerStars Hand #208658682651:  Hold'em No Limit ($0.01/$0.02 USD) - 2020/01/29 20:11:41 WET [2020/01/29 15:11:41 ET]
Table 'Brunonia IV' 6-max Seat #4 is the button
Seat 1: veltern ($0.74 in chips) 
Seat 2: goguxxl ($2.65 in chips) 
Seat 3: neHboK ($2.23 in chips) 
Seat 4: drakosveta ($0.92 in chips) 
Seat 5: Tassinari_86 ($5.56 in chips) 
Seat 6: Benzer586 ($2 in chips) 
Tassinari_86: posts small blind $0.01
Benzer586: posts big blind $0.02
*** HOLE CARDS ***
Dealt to Benzer586 [Ac Kh]
veltern: calls $0.02
goguxxl: folds 
neHboK: folds 
drakosveta: calls $0.02
Tassinari_86: calls $0.01
Benzer586: raises $0.04 to $0.06
veltern: calls $0.04
drakosveta: calls $0.04
Tassinari_86: folds 
*** FLOP *** [9h 2h 4d]
Benzer586: bets $0.10
veltern: calls $0.10
drakosveta: calls $0.10
*** TURN *** [9h 2h 4d] [5s]
Benzer586: checks 
veltern: bets $0.24
drakosveta: folds 
Benzer586: folds 
Uncalled bet ($0.24) returned to veltern
veltern collected $0.48 from pot
veltern: doesn't show hand 
*** SUMMARY ***
Total pot $0.50 | Rake $0.02 
Board [9h 2h 4d 5s]
Seat 1: veltern collected ($0.48)
Seat 2: goguxxl folded before Flop (didn't bet)
Seat 3: neHboK folded before Flop (didn't bet)
Seat 4: drakosveta (button) folded on the Turn
Seat 5: Tassinari_86 (small blind) folded before Flop
Seat 6: Benzer586 (big blind) folded on the Turn



PokerStars Hand #208658720595:  Hold'em No Limit ($0.01/$0.02 USD) - 2020/01/29 20:12:42 WET [2020/01/29 15:12:42 ET]
Table 'Brunonia IV' 6-max Seat #5 is the button
Seat 1: veltern ($1.06 in chips) 
Seat 2: goguxxl ($2.65 in chips) 
Seat 3: neHboK ($2.23 in chips) 
Seat 4: drakosveta ($0.76 in chips) 
Seat 5: Tassinari_86 ($5.54 in chips) 
Seat 6: Benzer586 ($1.84 in chips) 
Benzer586: posts small blind $0.01
veltern: posts big blind $0.02
*** HOLE CARDS ***
Dealt to Benzer586 [8s 9s]
goguxxl: folds 
neHboK: folds 
drakosveta: calls $0.02
Tassinari_86: folds 
Benzer586: calls $0.01
veltern: checks 
*** FLOP *** [4s 3h 9h]
Benzer586: bets $0.03
veltern: folds 
drakosveta: calls $0.03
*** TURN *** [4s 3h 9h] [Kd]
Benzer586: checks 
drakosveta: checks 
*** RIVER *** [4s 3h 9h Kd] [8c]
Benzer586: bets $0.12
drakosveta: folds 
Uncalled bet ($0.12) returned to Benzer586
Benzer586 collected $0.12 from pot
Benzer586: doesn't show hand 
*** SUMMARY ***
Total pot $0.12 | Rake $0 
Board [4s 3h 9h Kd 8c]
Seat 1: veltern (big blind) folded on the Flop
Seat 2: goguxxl folded before Flop (didn't bet)
Seat 3: neHboK folded before Flop (didn't bet)
Seat 4: drakosveta folded on the River
Seat 5: Tassinari_86 (button) folded before Flop (didn't bet)
Seat 6: Benzer586 (small blind) collected ($0.12)



PokerStars Hand #208658742670:  Hold'em No Limit ($0.01/$0.02 USD) - 2020/01/29 20:13:17 WET [2020/01/29 15:13:17 ET]
Table 'Brunonia IV' 6-max Seat #6 is the button
Seat 1: veltern ($1.04 in chips) 
Seat 2: goguxxl ($2.65 in chips) 
Seat 3: neHboK ($2.23 in chips) 
Seat 4: drakosveta ($0.71 in chips) 
Seat 5: Tassinari_86 ($5.54 in chips) 
Seat 6: Benzer586 ($1.91 in chips) 
veltern: posts small blind $0.01
goguxxl: posts big blind $0.02
*** HOLE CARDS ***
Dealt to Benzer586 [9c As]
neHboK: folds 
drakosveta: calls $0.02
Tassinari_86: folds 
Benzer586: calls $0.02
veltern: calls $0.01
goguxxl: checks 
*** FLOP *** [Js Qd 2c]
veltern: checks 
goguxxl: checks 
drakosveta: checks 
Benzer586: checks 
*** TURN *** [Js Qd 2c] [8d]
veltern: checks 
goguxxl: checks 
drakosveta: checks 
Benzer586: checks 
*** RIVER *** [Js Qd 2c 8d] [Td]
veltern: bets $0.04
goguxxl: folds 
drakosveta: folds 
Benzer586: raises $0.14 to $0.18
veltern: folds 
Uncalled bet ($0.14) returned to Benzer586
Benzer586 collected $0.15 from pot
Benzer586: doesn't show hand 
*** SUMMARY ***
Total pot $0.16 | Rake $0.01 
Board [Js Qd 2c 8d Td]
Seat 1: veltern (small blind) folded on the River
Seat 2: goguxxl (big blind) folded on the River
Seat 3: neHboK folded before Flop (didn't bet)
Seat 4: drakosveta folded on the River
Seat 5: Tassinari_86 folded before Flop (didn't bet)
Seat 6: Benzer586 (button) collected ($0.15)



PokerStars Hand #208658777163:  Hold'em No Limit ($0.01/$0.02 USD) - 2020/01/29 20:14:14 WET [2020/01/29 15:14:14 ET]
Table 'Brunonia IV' 6-max Seat #1 is the button
Seat 1: veltern ($0.98 in chips) 
Seat 2: goguxxl ($2.63 in chips) 
Seat 3: neHboK ($2.23 in chips) 
Seat 4: drakosveta ($0.69 in chips) 
Seat 5: Tassinari_86 ($5.54 in chips) 
Seat 6: Benzer586 ($2 in chips) 
goguxxl: posts small blind $0.01
neHboK: posts big blind $0.02
*** HOLE CARDS ***
Dealt to Benzer586 [8s As]
drakosveta: calls $0.02
Tassinari_86: folds 
Benzer586: folds 
veltern: calls $0.02
goguxxl: folds 
neHboK: checks 
*** FLOP *** [Qh 5h 8h]
neHboK: checks 
drakosveta: checks 
veltern: bets $0.07
neHboK: folds 
drakosveta: calls $0.07
*** TURN *** [Qh 5h 8h] [9c]
drakosveta: checks 
veltern: checks 
*** RIVER *** [Qh 5h 8h 9c] [2d]
drakosveta: bets $0.02
veltern: calls $0.02
*** SHOW DOWN ***
drakosveta: shows [Qd Jc] (a pair of Queens)
veltern: mucks hand 
drakosveta collected $0.24 from pot
*** SUMMARY ***
Total pot $0.25 | Rake $0.01 
Board [Qh 5h 8h 9c 2d]
Seat 1: veltern (button) mucked [Qs 3s]
Seat 2: goguxxl (small blind) folded before Flop
Seat 3: neHboK (big blind) folded on the Flop
Seat 4: drakosveta showed [Qd Jc] and won ($0.24) with a pair of Queens
Seat 5: Tassinari_86 folded before Flop (didn't bet)
Seat 6: Benzer586 folded before Flop (didn't bet)



PokerStars Hand #208658795849:  Hold'em No Limit ($0.01/$0.02 USD) - 2020/01/29 20:14:45 WET [2020/01/29 15:14:45 ET]
Table 'Brunonia IV' 6-max Seat #2 is the button
Seat 1: veltern ($0.87 in chips) 
Seat 2: goguxxl ($2.62 in chips) 
Seat 3: neHboK ($2.21 in chips) 
Seat 4: drakosveta ($0.82 in chips) 
Seat 5: Tassinari_86 ($5.54 in chips) 
Seat 6: Benzer586 ($2 in chips) 
neHboK: posts small blind $0.01
drakosveta: posts big blind $0.02
*** HOLE CARDS ***
Dealt to Benzer586 [6c Ks]
Tassinari_86: folds 
Benzer586: folds 
veltern: calls $0.02
goguxxl: folds 
neHboK: folds 
drakosveta: checks 
*** FLOP *** [6s Ah 3s]
drakosveta: checks 
veltern: checks 
*** TURN *** [6s Ah 3s] [3h]
drakosveta: bets $0.02
veltern: folds 
Uncalled bet ($0.02) returned to drakosveta
drakosveta collected $0.05 from pot
drakosveta: doesn't show hand 
*** SUMMARY ***
Total pot $0.05 | Rake $0 
Board [6s Ah 3s 3h]
Seat 1: veltern folded on the Turn
Seat 2: goguxxl (button) folded before Flop (didn't bet)
Seat 3: neHboK (small blind) folded before Flop
Seat 4: drakosveta (big blind) collected ($0.05)
Seat 5: Tassinari_86 folded before Flop (didn't bet)
Seat 6: Benzer586 folded before Flop (didn't bet)



PokerStars Hand #208658809695:  Hold'em No Limit ($0.01/$0.02 USD) - 2020/01/29 20:15:07 WET [2020/01/29 15:15:07 ET]
Table 'Brunonia IV' 6-max Seat #3 is the button
Seat 1: veltern ($0.85 in chips) 
Seat 2: goguxxl ($2.62 in chips) 
Seat 3: neHboK ($2.20 in chips) 
Seat 4: drakosveta ($0.85 in chips) 
Seat 5: Tassinari_86 ($5.54 in chips) 
Seat 6: Benzer586 ($2 in chips) 
drakosveta: posts small blind $0.01
Tassinari_86: posts big blind $0.02
*** HOLE CARDS ***
Dealt to Benzer586 [2h 5c]
Benzer586: folds 
veltern: calls $0.02
goguxxl: folds 
neHboK: folds 
drakosveta: calls $0.01
Tassinari_86: checks 
*** FLOP *** [Ac 6c 3c]
drakosveta: bets $0.02
Tassinari_86: folds 
veltern: calls $0.02
*** TURN *** [Ac 6c 3c] [Qc]
drakosveta: checks 
veltern: checks 
*** RIVER *** [Ac 6c 3c Qc] [5s]
drakosveta: bets $0.02
veltern: calls $0.02
*** SHOW DOWN ***
drakosveta: shows [2d Kh] (high card Ace)
veltern: shows [7h 4c] (a flush, Ace high)
veltern collected $0.14 from pot
*** SUMMARY ***
Total pot $0.14 | Rake $0 
Board [Ac 6c 3c Qc 5s]
Seat 1: veltern showed [7h 4c] and won ($0.14) with a flush, Ace high
Seat 2: goguxxl folded before Flop (didn't bet)
Seat 3: neHboK (button) folded before Flop (didn't bet)
Seat 4: drakosveta (small blind) showed [2d Kh] and lost with high card Ace
Seat 5: Tassinari_86 (big blind) folded on the Flop
Seat 6: Benzer586 folded before Flop (didn't bet)



PokerStars Hand #208658825637:  Hold'em No Limit ($0.01/$0.02 USD) - 2020/01/29 20:15:32 WET [2020/01/29 15:15:32 ET]
Table 'Brunonia IV' 6-max Seat #4 is the button
Seat 1: veltern ($0.93 in chips) 
Seat 2: goguxxl ($2.62 in chips) 
Seat 3: neHboK ($2.20 in chips) 
Seat 4: drakosveta ($0.79 in chips) 
Seat 5: Tassinari_86 ($5.52 in chips) 
Seat 6: Benzer586 ($2 in chips) 
Tassinari_86: posts small blind $0.01
Benzer586: posts big blind $0.02
*** HOLE CARDS ***
Dealt to Benzer586 [Jc 8c]
veltern: calls $0.02
goguxxl: raises $0.06 to $0.08
neHboK: folds 
drakosveta: calls $0.08
Tassinari_86: folds 
Benzer586: folds 
veltern: calls $0.06
*** FLOP *** [9h As Kd]
veltern: checks 
goguxxl: bets $0.14
drakosveta: folds 
veltern: folds 
Uncalled bet ($0.14) returned to goguxxl
goguxxl collected $0.26 from pot
*** SUMMARY ***
Total pot $0.27 | Rake $0.01 
Board [9h As Kd]
Seat 1: veltern folded on the Flop
Seat 2: goguxxl collected ($0.26)
Seat 3: neHboK folded before Flop (didn't bet)
Seat 4: drakosveta (button) folded on the Flop
Seat 5: Tassinari_86 (small blind) folded before Flop
Seat 6: Benzer586 (big blind) folded before Flop



PokerStars Hand #208658859325:  Hold'em No Limit ($0.01/$0.02 USD) - 2020/01/29 20:16:26 WET [2020/01/29 15:16:26 ET]
Table 'Brunonia IV' 6-max Seat #5 is the button
Seat 1: veltern ($0.85 in chips) 
Seat 2: goguxxl ($2.80 in chips) 
Seat 3: neHboK ($2.20 in chips) 
Seat 4: drakosveta ($0.71 in chips) 
Seat 5: Tassinari_86 ($5.51 in chips) 
Seat 6: Benzer586 ($1.98 in chips) 
Benzer586: posts small blind $0.01
veltern: posts big blind $0.02
*** HOLE CARDS ***
Dealt to Benzer586 [6c 6s]
goguxxl: folds 
neHboK: folds 
drakosveta: calls $0.02
Tassinari_86: raises $0.04 to $0.06
Benzer586: calls $0.05
veltern: folds 
drakosveta: calls $0.04
*** FLOP *** [9d 4c 6d]
Benzer586: bets $0.14
drakosveta: folds 
Tassinari_86: calls $0.14
*** TURN *** [9d 4c 6d] [3s]
Benzer586: bets $0.23
Tassinari_86: calls $0.23
*** RIVER *** [9d 4c 6d 3s] [4d]
Benzer586: checks 
Tassinari_86: checks 
*** SHOW DOWN ***
Benzer586: shows [6c 6s] (a full house, Sixes full of Fours)
Tassinari_86: mucks hand 
Benzer586 collected $0.91 from pot
*** SUMMARY ***
Total pot $0.94 | Rake $0.03 
Board [9d 4c 6d 3s 4d]
Seat 1: veltern (big blind) folded before Flop
Seat 2: goguxxl folded before Flop (didn't bet)
Seat 3: neHboK folded before Flop (didn't bet)
Seat 4: drakosveta folded on the Flop
Seat 5: Tassinari_86 (button) mucked [Th 9c]
Seat 6: Benzer586 (small blind) showed [6c 6s] and won ($0.91) with a full house, Sixes full of Fours



PokerStars Hand #208658890738:  Hold'em No Limit ($0.01/$0.02 USD) - 2020/01/29 20:17:17 WET [2020/01/29 15:17:17 ET]
Table 'Brunonia IV' 6-max Seat #6 is the button
Seat 1: veltern ($0.83 in chips) 
Seat 3: neHboK ($2.20 in chips) 
Seat 4: drakosveta ($0.65 in chips) 
Seat 5: Tassinari_86 ($5.08 in chips) 
Seat 6: Benzer586 ($2.46 in chips) 
veltern: posts small blind $0.01
goguxxl: is sitting out 
neHboK: posts big blind $0.02
*** HOLE CARDS ***
Dealt to Benzer586 [2d 9h]
goguxxl leaves the table
drakosveta: calls $0.02
Tassinari_86: folds 
Benzer586: folds 
veltern: calls $0.01
neHboK: checks 
*** FLOP *** [4h Ah 4d]
veltern: checks 
neHboK: checks 
drakosveta: bets $0.02
veltern: calls $0.02
neHboK: folds 
*** TURN *** [4h Ah 4d] [7c]
veltern: checks 
drakosveta: bets $0.02
veltern: calls $0.02
*** RIVER *** [4h Ah 4d 7c] [8d]
veltern: checks 
drakosveta: checks 
*** SHOW DOWN ***
veltern: shows [9s 8h] (two pair, Eights and Fours)
drakosveta: mucks hand 
veltern collected $0.14 from pot
*** SUMMARY ***
Total pot $0.14 | Rake $0 
Board [4h Ah 4d 7c 8d]
Seat 1: veltern (small blind) showed [9s 8h] and won ($0.14) with two pair, Eights and Fours
Seat 3: neHboK (big blind) folded on the Flop
Seat 4: drakosveta mucked [Th Jc]
Seat 5: Tassinari_86 folded before Flop (didn't bet)
Seat 6: Benzer586 (button) folded before Flop (didn't bet)



PokerStars Hand #208658914948:  Hold'em No Limit ($0.01/$0.02 USD) - 2020/01/29 20:17:55 WET [2020/01/29 15:17:55 ET]
Table 'Brunonia IV' 6-max Seat #1 is the button
Seat 1: veltern ($0.91 in chips) 
Seat 3: neHboK ($2.18 in chips) 
Seat 4: drakosveta ($0.59 in chips) 
Seat 5: Tassinari_86 ($5.08 in chips) 
Seat 6: Benzer586 ($2.46 in chips) 
neHboK: posts small blind $0.01
drakosveta: posts big blind $0.02
*** HOLE CARDS ***
Dealt to Benzer586 [Kd 5c]
Tassinari_86: folds 
Benzer586: folds 
veltern: raises $0.02 to $0.04
neHboK: folds 
drakosveta: calls $0.02
*** FLOP *** [3h 7h 4h]
drakosveta: bets $0.02
veltern: folds 
Uncalled bet ($0.02) returned to drakosveta
drakosveta collected $0.09 from pot
drakosveta: doesn't show hand 
*** SUMMARY ***
Total pot $0.09 | Rake $0 
Board [3h 7h 4h]
Seat 1: veltern (button) folded on the Flop
Seat 3: neHboK (small blind) folded before Flop
Seat 4: drakosveta (big blind) collected ($0.09)
Seat 5: Tassinari_86 folded before Flop (didn't bet)
Seat 6: Benzer586 folded before Flop (didn't bet)



PokerStars Hand #208658925479:  Hold'em No Limit ($0.01/$0.02 USD) - 2020/01/29 20:18:13 WET [2020/01/29 15:18:13 ET]
Table 'Brunonia IV' 6-max Seat #3 is the button
Seat 1: veltern ($0.87 in chips) 
Seat 3: neHboK ($2.17 in chips) 
Seat 4: drakosveta ($0.64 in chips) 
Seat 5: Tassinari_86 ($5.08 in chips) 
Seat 6: Benzer586 ($2.46 in chips) 
drakosveta: posts small blind $0.01
Tassinari_86: posts big blind $0.02
*** HOLE CARDS ***
Dealt to Benzer586 [8c Qc]
Benzer586: folds 
veltern: folds 
neHboK: folds 
drakosveta: calls $0.01
Tassinari_86: raises $0.06 to $0.08
drakosveta: calls $0.06
*** FLOP *** [6s 2d 3d]
drakosveta: checks 
Tassinari_86: bets $0.10
drakosveta: calls $0.10
*** TURN *** [6s 2d 3d] [3h]
drakosveta: checks 
Tassinari_86: bets $0.22
drakosveta: calls $0.22
*** RIVER *** [6s 2d 3d 3h] [Ad]
drakosveta: bets $0.02
Tassinari_86: raises $0.41 to $0.43
drakosveta: calls $0.22 and is all-in
Uncalled bet ($0.19) returned to Tassinari_86
*** SHOW DOWN ***
Tassinari_86: shows [Qd Jc] (a pair of Threes)
drakosveta: shows [7d Jd] (a flush, Ace high)
drakosveta collected $1.24 from pot
*** SUMMARY ***
Total pot $1.28 | Rake $0.04 
Board [6s 2d 3d 3h Ad]
Seat 1: veltern folded before Flop (didn't bet)
Seat 3: neHboK (button) folded before Flop (didn't bet)
Seat 4: drakosveta (small blind) showed [7d Jd] and won ($1.24) with a flush, Ace high
Seat 5: Tassinari_86 (big blind) showed [Qd Jc] and lost with a pair of Threes
Seat 6: Benzer586 folded before Flop (didn't bet)



PokerStars Hand #208658949479:  Hold'em No Limit ($0.01/$0.02 USD) - 2020/01/29 20:18:51 WET [2020/01/29 15:18:51 ET]
Table 'Brunonia IV' 6-max Seat #4 is the button
Seat 1: veltern ($0.87 in chips) 
Seat 3: neHboK ($2.17 in chips) 
Seat 4: drakosveta ($1.24 in chips) 
Seat 5: Tassinari_86 ($4.44 in chips) 
Seat 6: Benzer586 ($2.46 in chips) 
Tassinari_86: posts small blind $0.01
Benzer586: posts big blind $0.02
*** HOLE CARDS ***
Dealt to Benzer586 [7s 8h]
veltern: calls $0.02
neHboK: folds 
drakosveta: calls $0.02
Tassinari_86: raises $0.04 to $0.06
S.Czek joins the table at seat #2 
Benzer586: calls $0.04
veltern: calls $0.04
drakosveta: calls $0.04
*** FLOP *** [6s As Ks]
Tassinari_86: checks 
Benzer586: checks 
veltern: checks 
drakosveta: checks 
*** TURN *** [6s As Ks] [Kc]
Tassinari_86: checks 
Benzer586: checks 
veltern: checks 
drakosveta: bets $0.02
Tassinari_86: calls $0.02
Benzer586: calls $0.02
veltern: calls $0.02
*** RIVER *** [6s As Ks Kc] [3d]
Tassinari_86: checks 
Benzer586: checks 
veltern: checks 
drakosveta: bets $0.24
Tassinari_86: folds 
Benzer586: folds 
veltern: folds 
Uncalled bet ($0.24) returned to drakosveta
drakosveta collected $0.31 from pot
drakosveta: doesn't show hand 
*** SUMMARY ***
Total pot $0.32 | Rake $0.01 
Board [6s As Ks Kc 3d]
Seat 1: veltern folded on the River
Seat 3: neHboK folded before Flop (didn't bet)
Seat 4: drakosveta (button) collected ($0.31)
Seat 5: Tassinari_86 (small blind) folded on the River
Seat 6: Benzer586 (big blind) folded on the River



PokerStars Hand #208658990225:  Hold'em No Limit ($0.01/$0.02 USD) - 2020/01/29 20:19:58 WET [2020/01/29 15:19:58 ET]
Table 'Brunonia IV' 6-max Seat #5 is the button
Seat 1: veltern ($0.79 in chips) 
Seat 3: neHboK ($2.17 in chips) 
Seat 4: drakosveta ($1.47 in chips) 
Seat 5: Tassinari_86 ($4.36 in chips) 
Seat 6: Benzer586 ($2.38 in chips) 
Benzer586: posts small blind $0.01
veltern: posts big blind $0.02
S.Czek: sits out 
*** HOLE CARDS ***
Dealt to Benzer586 [5d 5h]
neHboK: folds 
drakosveta: calls $0.02
Tassinari_86: raises $0.04 to $0.06
Benzer586: calls $0.05
veltern: folds 
drakosveta: calls $0.04
*** FLOP *** [6d 3s Kc]
Benzer586: checks 
drakosveta: checks 
Tassinari_86: bets $0.12
Benzer586: folds 
drakosveta: folds 
Uncalled bet ($0.12) returned to Tassinari_86
Tassinari_86 collected $0.19 from pot
Tassinari_86: doesn't show hand 
*** SUMMARY ***
Total pot $0.20 | Rake $0.01 
Board [6d 3s Kc]
Seat 1: veltern (big blind) folded before Flop
Seat 3: neHboK folded before Flop (didn't bet)
Seat 4: drakosveta folded on the Flop
Seat 5: Tassinari_86 (button) collected ($0.19)
Seat 6: Benzer586 (small blind) folded on the Flop



PokerStars Hand #208659014150:  Hold'em No Limit ($0.01/$0.02 USD) - 2020/01/29 20:20:37 WET [2020/01/29 15:20:37 ET]
Table 'Brunonia IV' 6-max Seat #6 is the button
Seat 1: veltern ($0.77 in chips) 
Seat 2: S.Czek ($2 in chips) 
Seat 3: neHboK ($2.17 in chips) 
Seat 4: drakosveta ($1.41 in chips) 
Seat 5: Tassinari_86 ($4.49 in chips) 
Seat 6: Benzer586 ($2.32 in chips) 
veltern: posts small blind $0.01
S.Czek: posts big blind $0.02
*** HOLE CARDS ***
Dealt to Benzer586 [4h 2s]
neHboK: folds 
drakosveta: calls $0.02
Tassinari_86: folds 
Benzer586: folds 
veltern: raises $0.02 to $0.04
S.Czek: folds 
drakosveta: calls $0.02
*** FLOP *** [Qs Qh 3c]
veltern: checks 
drakosveta: checks 
*** TURN *** [Qs Qh 3c] [3s]
veltern: checks 
drakosveta: checks 
*** RIVER *** [Qs Qh 3c 3s] [Jc]
veltern: checks 
drakosveta: checks 
*** SHOW DOWN ***
veltern: shows [Kd Jd] (two pair, Queens and Jacks)
drakosveta: mucks hand 
veltern collected $0.10 from pot
*** SUMMARY ***
Total pot $0.10 | Rake $0 
Board [Qs Qh 3c 3s Jc]
Seat 1: veltern (small blind) showed [Kd Jd] and won ($0.10) with two pair, Queens and Jacks
Seat 2: S.Czek (big blind) folded before Flop
Seat 3: neHboK folded before Flop (didn't bet)
Seat 4: drakosveta mucked [Ac Ts]
Seat 5: Tassinari_86 folded before Flop (didn't bet)
Seat 6: Benzer586 (button) folded before Flop (didn't bet)



PokerStars Hand #208659044073:  Hold'em No Limit ($0.01/$0.02 USD) - 2020/01/29 20:21:22 WET [2020/01/29 15:21:22 ET]
Table 'Brunonia IV' 6-max Seat #1 is the button
Seat 1: veltern ($0.83 in chips) 
Seat 2: S.Czek ($1.98 in chips) 
Seat 3: neHboK ($2.17 in chips) 
Seat 4: drakosveta ($1.37 in chips) 
Seat 5: Tassinari_86 ($4.49 in chips) 
Seat 6: Benzer586 ($2.32 in chips) 
S.Czek: posts small blind $0.01
neHboK: posts big blind $0.02
*** HOLE CARDS ***
Dealt to Benzer586 [2c Js]
drakosveta: calls $0.02
Tassinari_86: folds 
Benzer586: folds 
veltern: calls $0.02
S.Czek: folds 
neHboK: checks 
*** FLOP *** [8d Ts 8s]
neHboK: checks 
drakosveta: bets $0.02
veltern: calls $0.02
neHboK: calls $0.02
*** TURN *** [8d Ts 8s] [4h]
neHboK: checks 
drakosveta: bets $0.02
veltern: calls $0.02
neHboK: calls $0.02
*** RIVER *** [8d Ts 8s 4h] [5s]
neHboK: checks 
drakosveta: bets $0.02
veltern: calls $0.02
neHboK: raises $0.09 to $0.11
drakosveta: calls $0.09
veltern: folds 
*** SHOW DOWN ***
neHboK: shows [Ks 3s] (a flush, King high)
drakosveta: mucks hand 
neHboK collected $0.41 from pot
*** SUMMARY ***
Total pot $0.43 | Rake $0.02 
Board [8d Ts 8s 4h 5s]
Seat 1: veltern (button) folded on the River
Seat 2: S.Czek (small blind) folded before Flop
Seat 3: neHboK (big blind) showed [Ks 3s] and won ($0.41) with a flush, King high
Seat 4: drakosveta mucked [Tc 9d]
Seat 5: Tassinari_86 folded before Flop (didn't bet)
Seat 6: Benzer586 folded before Flop (didn't bet)



PokerStars Hand #208659077836:  Hold'em No Limit ($0.01/$0.02 USD) - 2020/01/29 20:22:16 WET [2020/01/29 15:22:16 ET]
Table 'Brunonia IV' 6-max Seat #2 is the button
Seat 1: veltern ($0.75 in chips) 
Seat 2: S.Czek ($1.97 in chips) 
Seat 3: neHboK ($2.41 in chips) 
Seat 4: drakosveta ($1.20 in chips) 
Seat 5: Tassinari_86 ($4.49 in chips) 
Seat 6: Benzer586 ($2.32 in chips) 
neHboK: posts small blind $0.01
drakosveta: posts big blind $0.02
*** HOLE CARDS ***
Dealt to Benzer586 [2c 8h]
Tassinari_86: folds 
Benzer586: folds 
veltern: raises $0.02 to $0.04
S.Czek: raises $0.06 to $0.10
neHboK: folds 
drakosveta: calls $0.08
veltern: raises $0.06 to $0.16
S.Czek: folds 
drakosveta: calls $0.06
*** FLOP *** [Kc 5h Js]
drakosveta: bets $0.02
veltern: raises $0.23 to $0.25
drakosveta: calls $0.23
*** TURN *** [Kc 5h Js] [Kd]
drakosveta: bets $0.10
veltern: raises $0.24 to $0.34 and is all-in
drakosveta: folds 
Uncalled bet ($0.24) returned to veltern
veltern collected $1.09 from pot
veltern: doesn't show hand 
*** SUMMARY ***
Total pot $1.13 | Rake $0.04 
Board [Kc 5h Js Kd]
Seat 1: veltern collected ($1.09)
Seat 2: S.Czek (button) folded before Flop
Seat 3: neHboK (small blind) folded before Flop
Seat 4: drakosveta (big blind) folded on the Turn
Seat 5: Tassinari_86 folded before Flop (didn't bet)
Seat 6: Benzer586 folded before Flop (didn't bet)



PokerStars Hand #208659107041:  Hold'em No Limit ($0.01/$0.02 USD) - 2020/01/29 20:23:03 WET [2020/01/29 15:23:03 ET]
Table 'Brunonia IV' 6-max Seat #3 is the button
Seat 1: veltern ($1.33 in chips) 
Seat 2: S.Czek ($1.87 in chips) 
Seat 3: neHboK ($2.40 in chips) 
Seat 4: drakosveta ($0.69 in chips) 
Seat 5: Tassinari_86 ($4.49 in chips) 
Seat 6: Benzer586 ($2.32 in chips) 
drakosveta: posts small blind $0.01
Tassinari_86: posts big blind $0.02
*** HOLE CARDS ***
Dealt to Benzer586 [6s Jc]
Benzer586: folds 
veltern: raises $0.02 to $0.04
S.Czek: folds 
neHboK: folds 
drakosveta: calls $0.03
Tassinari_86: folds 
*** FLOP *** [Kd 2s 9d]
drakosveta: checks 
veltern: bets $0.05
drakosveta: folds 
Uncalled bet ($0.05) returned to veltern
veltern collected $0.10 from pot
veltern: doesn't show hand 
*** SUMMARY ***
Total pot $0.10 | Rake $0 
Board [Kd 2s 9d]
Seat 1: veltern collected ($0.10)
Seat 2: S.Czek folded before Flop (didn't bet)
Seat 3: neHboK (button) folded before Flop (didn't bet)
Seat 4: drakosveta (small blind) folded on the Flop
Seat 5: Tassinari_86 (big blind) folded before Flop
Seat 6: Benzer586 folded before Flop (didn't bet)



PokerStars Hand #208659120351:  Hold'em No Limit ($0.01/$0.02 USD) - 2020/01/29 20:23:25 WET [2020/01/29 15:23:25 ET]
Table 'Brunonia IV' 6-max Seat #4 is the button
Seat 1: veltern ($1.39 in chips) 
Seat 2: S.Czek ($1.87 in chips) 
Seat 3: neHboK ($2.40 in chips) 
Seat 4: drakosveta ($0.65 in chips) 
Seat 5: Tassinari_86 ($4.47 in chips) 
Seat 6: Benzer586 ($2.32 in chips) 
Tassinari_86: posts small blind $0.01
Benzer586: posts big blind $0.02
*** HOLE CARDS ***
Dealt to Benzer586 [As 6s]
veltern: folds 
S.Czek: folds 
neHboK: folds 
drakosveta: calls $0.02
Tassinari_86: calls $0.01
Benzer586: checks 
*** FLOP *** [3d 3c Qd]
Tassinari_86: checks 
Benzer586: checks 
drakosveta: checks 
*** TURN *** [3d 3c Qd] [9s]
Tassinari_86: checks 
Benzer586: checks 
drakosveta: checks 
*** RIVER *** [3d 3c Qd 9s] [9d]
Tassinari_86: checks 
Benzer586: checks 
drakosveta: checks 
*** SHOW DOWN ***
Tassinari_86: shows [6c 5h] (two pair, Nines and Threes)
Benzer586: shows [As 6s] (two pair, Nines and Threes - Ace kicker)
drakosveta: mucks hand 
Benzer586 collected $0.06 from pot
*** SUMMARY ***
Total pot $0.06 | Rake $0 
Board [3d 3c Qd 9s 9d]
Seat 1: veltern folded before Flop (didn't bet)
Seat 2: S.Czek folded before Flop (didn't bet)
Seat 3: neHboK folded before Flop (didn't bet)
Seat 4: drakosveta (button) mucked [5s Tc]
Seat 5: Tassinari_86 (small blind) showed [6c 5h] and lost with two pair, Nines and Threes
Seat 6: Benzer586 (big blind) showed [As 6s] and won ($0.06) with two pair, Nines and Threes



PokerStars Hand #208659141109:  Hold'em No Limit ($0.01/$0.02 USD) - 2020/01/29 20:23:58 WET [2020/01/29 15:23:58 ET]
Table 'Brunonia IV' 6-max Seat #5 is the button
Seat 1: veltern ($1.39 in chips) 
Seat 2: S.Czek ($1.87 in chips) 
Seat 3: neHboK ($2.40 in chips) 
Seat 4: drakosveta ($0.63 in chips) 
Seat 5: Tassinari_86 ($4.45 in chips) 
Seat 6: Benzer586 ($2.36 in chips) 
Benzer586: posts small blind $0.01
veltern: posts big blind $0.02
*** HOLE CARDS ***
Dealt to Benzer586 [Jh 5d]
S.Czek: folds 
neHboK: folds 
drakosveta: calls $0.02
Tassinari_86: raises $0.04 to $0.06
Benzer586: folds 
veltern: folds 
drakosveta: calls $0.04
*** FLOP *** [Ts Qs Jd]
drakosveta: checks 
Tassinari_86: bets $0.07
drakosveta: calls $0.07
*** TURN *** [Ts Qs Jd] [5c]
drakosveta: bets $0.02
Tassinari_86: calls $0.02
*** RIVER *** [Ts Qs Jd 5c] [4h]
drakosveta: bets $0.02
Tassinari_86: calls $0.02
*** SHOW DOWN ***
drakosveta: shows [9d 9h] (a pair of Nines)
Tassinari_86: mucks hand 
drakosveta collected $0.36 from pot
*** SUMMARY ***
Total pot $0.37 | Rake $0.01 
Board [Ts Qs Jd 5c 4h]
Seat 1: veltern (big blind) folded before Flop
Seat 2: S.Czek folded before Flop (didn't bet)
Seat 3: neHboK folded before Flop (didn't bet)
Seat 4: drakosveta showed [9d 9h] and won ($0.36) with a pair of Nines
Seat 5: Tassinari_86 (button) mucked [Kd 3d]
Seat 6: Benzer586 (small blind) folded before Flop



PokerStars Hand #208659157687:  Hold'em No Limit ($0.01/$0.02 USD) - 2020/01/29 20:24:25 WET [2020/01/29 15:24:25 ET]
Table 'Brunonia IV' 6-max Seat #6 is the button
Seat 1: veltern ($1.37 in chips) 
Seat 2: S.Czek ($1.87 in chips) 
Seat 3: neHboK ($2.40 in chips) 
Seat 4: drakosveta ($0.82 in chips) 
Seat 5: Tassinari_86 ($4.28 in chips) 
Seat 6: Benzer586 ($2.35 in chips) 
veltern: posts small blind $0.01
S.Czek: posts big blind $0.02
*** HOLE CARDS ***
Dealt to Benzer586 [3h Th]
neHboK: folds 
drakosveta: calls $0.02
Tassinari_86: folds 
neHboK leaves the table
Benzer586: folds 
veltern: folds 
S.Czek: checks 
*** FLOP *** [8d Jc 3c]
S.Czek: checks 
drakosveta: checks 
*** TURN *** [8d Jc 3c] [Qs]
S.Czek: bets $0.04
drakosveta: calls $0.04
*** RIVER *** [8d Jc 3c Qs] [Qh]
S.Czek: bets $0.13
drakosveta: folds 
Uncalled bet ($0.13) returned to S.Czek
S.Czek collected $0.13 from pot
S.Czek: doesn't show hand 
*** SUMMARY ***
Total pot $0.13 | Rake $0 
Board [8d Jc 3c Qs Qh]
Seat 1: veltern (small blind) folded before Flop
Seat 2: S.Czek (big blind) collected ($0.13)
Seat 3: neHboK folded before Flop (didn't bet)
Seat 4: drakosveta folded on the River
Seat 5: Tassinari_86 folded before Flop (didn't bet)
Seat 6: Benzer586 (button) folded before Flop (didn't bet)



PokerStars Hand #208659172239:  Hold'em No Limit ($0.01/$0.02 USD) - 2020/01/29 20:24:49 WET [2020/01/29 15:24:49 ET]
Table 'Brunonia IV' 6-max Seat #1 is the button
Seat 1: veltern ($1.36 in chips) 
Seat 2: S.Czek ($1.94 in chips) 
Seat 4: drakosveta ($0.76 in chips) 
Seat 5: Tassinari_86 ($4.28 in chips) 
Seat 6: Benzer586 ($2.35 in chips) 
S.Czek: posts small blind $0.01
drakosveta: posts big blind $0.02
*** HOLE CARDS ***
Dealt to Benzer586 [Kc Th]
Tassinari_86: folds 
Benzer586: calls $0.02
veltern: calls $0.02
S.Czek: calls $0.01
drakosveta: checks 
*** FLOP *** [Qs 8c 4s]
S.Czek: checks 
drakosveta: checks 
Benzer586: checks 
veltern: bets $0.04
S.Czek: calls $0.04
drakosveta: calls $0.04
Benzer586: folds 
*** TURN *** [Qs 8c 4s] [Ac]
S.Czek: checks 
drakosveta: bets $0.02
veltern: raises $0.12 to $0.14
S.Czek: calls $0.14
drakosveta: calls $0.12
*** RIVER *** [Qs 8c 4s Ac] [9h]
S.Czek: checks 
drakosveta: checks 
veltern: checks 
*** SHOW DOWN ***
S.Czek: shows [3c Qc] (a pair of Queens)
drakosveta: mucks hand 
veltern: shows [Qd 6h] (a pair of Queens)
S.Czek collected $0.30 from pot
veltern collected $0.30 from pot
*** SUMMARY ***
Total pot $0.62 | Rake $0.02 
Board [Qs 8c 4s Ac 9h]
Seat 1: veltern (button) showed [Qd 6h] and won ($0.30) with a pair of Queens
Seat 2: S.Czek (small blind) showed [3c Qc] and won ($0.30) with a pair of Queens
Seat 4: drakosveta (big blind) mucked [6s 3s]
Seat 5: Tassinari_86 folded before Flop (didn't bet)
Seat 6: Benzer586 folded on the Flop



PokerStars Hand #208659202465:  Hold'em No Limit ($0.01/$0.02 USD) - 2020/01/29 20:25:36 WET [2020/01/29 15:25:36 ET]
Table 'Brunonia IV' 6-max Seat #2 is the button
Seat 1: veltern ($1.46 in chips) 
Seat 2: S.Czek ($2.04 in chips) 
Seat 4: drakosveta ($0.56 in chips) 
Seat 5: Tassinari_86 ($4.28 in chips) 
Seat 6: Benzer586 ($2.33 in chips) 
drakosveta: posts small blind $0.01
Tassinari_86: posts big blind $0.02
*** HOLE CARDS ***
Dealt to Benzer586 [3d 2c]
Benzer586: folds 
veltern: raises $0.02 to $0.04
S.Czek: folds 
drakosveta: calls $0.03
RedWhitePro joins the table at seat #3 
Tassinari_86: calls $0.02
*** FLOP *** [3c Jh 8d]
drakosveta: bets $0.02
Tassinari_86: calls $0.02
veltern: raises $0.02 to $0.04
drakosveta: calls $0.02
Tassinari_86: calls $0.02
*** TURN *** [3c Jh 8d] [9c]
drakosveta: bets $0.02
Tassinari_86: calls $0.02
veltern: raises $0.06 to $0.08
drakosveta: calls $0.06
Tassinari_86: folds 
*** RIVER *** [3c Jh 8d 9c] [Kd]
drakosveta: checks 
veltern: checks 
*** SHOW DOWN ***
drakosveta: shows [8h Ac] (a pair of Eights)
veltern: shows [Qd Qs] (a pair of Queens)
veltern collected $0.41 from pot
*** SUMMARY ***
Total pot $0.42 | Rake $0.01 
Board [3c Jh 8d 9c Kd]
Seat 1: veltern showed [Qd Qs] and won ($0.41) with a pair of Queens
Seat 2: S.Czek (button) folded before Flop (didn't bet)
Seat 4: drakosveta (small blind) showed [8h Ac] and lost with a pair of Eights
Seat 5: Tassinari_86 (big blind) folded on the Turn
Seat 6: Benzer586 folded before Flop (didn't bet)



PokerStars Hand #208659235855:  Hold'em No Limit ($0.01/$0.02 USD) - 2020/01/29 20:26:29 WET [2020/01/29 15:26:29 ET]
Table 'Brunonia IV' 6-max Seat #4 is the button
Seat 1: veltern ($1.71 in chips) 
Seat 2: S.Czek ($2.04 in chips) 
Seat 4: drakosveta ($0.40 in chips) 
Seat 5: Tassinari_86 ($4.18 in chips) 
Seat 6: Benzer586 ($2.33 in chips) 
Tassinari_86: posts small blind $0.01
Benzer586: posts big blind $0.02
RedWhitePro: sits out 
*** HOLE CARDS ***
Dealt to Benzer586 [Kd 6d]
veltern: calls $0.02
S.Czek: folds 
drakosveta: calls $0.02
Tassinari_86: calls $0.01
Benzer586: checks 
*** FLOP *** [2h Jc Ts]
Tassinari_86: checks 
Benzer586: checks 
veltern: checks 
drakosveta: checks 
*** TURN *** [2h Jc Ts] [7s]
Tassinari_86: bets $0.04
Benzer586: folds 
veltern: calls $0.04
drakosveta: calls $0.04
*** RIVER *** [2h Jc Ts 7s] [4h]
Tassinari_86: bets $0.12
veltern: folds 
drakosveta: calls $0.12
*** SHOW DOWN ***
Tassinari_86: shows [6s Jd] (a pair of Jacks)
drakosveta: mucks hand 
Tassinari_86 collected $0.42 from pot
*** SUMMARY ***
Total pot $0.44 | Rake $0.02 
Board [2h Jc Ts 7s 4h]
Seat 1: veltern folded on the River
Seat 2: S.Czek folded before Flop (didn't bet)
Seat 4: drakosveta (button) mucked [9h 7c]
Seat 5: Tassinari_86 (small blind) showed [6s Jd] and won ($0.42) with a pair of Jacks
Seat 6: Benzer586 (big blind) folded on the Turn



PokerStars Hand #208659259453:  Hold'em No Limit ($0.01/$0.02 USD) - 2020/01/29 20:27:07 WET [2020/01/29 15:27:07 ET]
Table 'Brunonia IV' 6-max Seat #5 is the button
Seat 1: veltern ($1.65 in chips) 
Seat 2: S.Czek ($2.04 in chips) 
Seat 4: drakosveta ($0.22 in chips) 
Seat 5: Tassinari_86 ($4.42 in chips) 
Seat 6: Benzer586 ($2.31 in chips) 
Benzer586: posts small blind $0.01
veltern: posts big blind $0.02
RedWhitePro: sits out 
*** HOLE CARDS ***
Dealt to Benzer586 [5d 7h]
S.Czek: folds 
drakosveta: calls $0.02
Tassinari_86: folds 
Benzer586: folds 
veltern: checks 
*** FLOP *** [Qs 3d 9d]
veltern: bets $0.02
drakosveta: calls $0.02
*** TURN *** [Qs 3d 9d] [Js]
veltern: bets $0.02
drakosveta: folds 
Uncalled bet ($0.02) returned to veltern
veltern collected $0.09 from pot
veltern: doesn't show hand 
*** SUMMARY ***
Total pot $0.09 | Rake $0 
Board [Qs 3d 9d Js]
Seat 1: veltern (big blind) collected ($0.09)
Seat 2: S.Czek folded before Flop (didn't bet)
Seat 4: drakosveta folded on the Turn
Seat 5: Tassinari_86 (button) folded before Flop (didn't bet)
Seat 6: Benzer586 (small blind) folded before Flop



PokerStars Hand #208659279170:  Hold'em No Limit ($0.01/$0.02 USD) - 2020/01/29 20:27:39 WET [2020/01/29 15:27:39 ET]
Table 'Brunonia IV' 6-max Seat #6 is the button
Seat 1: veltern ($1.70 in chips) 
Seat 2: S.Czek ($2.04 in chips) 
Seat 4: drakosveta ($0.18 in chips) 
Seat 5: Tassinari_86 ($4.42 in chips) 
Seat 6: Benzer586 ($2.30 in chips) 
veltern: posts small blind $0.01
S.Czek: posts big blind $0.02
RedWhitePro: sits out 
*** HOLE CARDS ***
Dealt to Benzer586 [Jd 2d]
drakosveta: calls $0.02
Tassinari_86: raises $0.04 to $0.06
Benzer586: folds 
veltern: calls $0.05
S.Czek: folds 
drakosveta: calls $0.04
*** FLOP *** [9d 4h 2s]
veltern: checks 
drakosveta: checks 
Tassinari_86: checks 
*** TURN *** [9d 4h 2s] [Qd]
veltern: checks 
drakosveta: checks 
Tassinari_86: checks 
*** RIVER *** [9d 4h 2s Qd] [5s]
veltern: checks 
drakosveta: checks 
Tassinari_86: bets $0.15
veltern: folds 
drakosveta: calls $0.12 and is all-in
Uncalled bet ($0.03) returned to Tassinari_86
*** SHOW DOWN ***
Tassinari_86: shows [8d Td] (high card Queen)
drakosveta: shows [8h 9h] (a pair of Nines)
drakosveta collected $0.42 from pot
*** SUMMARY ***
Total pot $0.44 | Rake $0.02 
Board [9d 4h 2s Qd 5s]
Seat 1: veltern (small blind) folded on the River
Seat 2: S.Czek (big blind) folded before Flop
Seat 4: drakosveta showed [8h 9h] and won ($0.42) with a pair of Nines
Seat 5: Tassinari_86 showed [8d Td] and lost with high card Queen
Seat 6: Benzer586 (button) folded before Flop (didn't bet)



PokerStars Hand #208659308702:  Hold'em No Limit ($0.01/$0.02 USD) - 2020/01/29 20:28:25 WET [2020/01/29 15:28:25 ET]
Table 'Brunonia IV' 6-max Seat #1 is the button
Seat 1: veltern ($1.64 in chips) 
Seat 2: S.Czek ($2.02 in chips) 
Seat 3: RedWhitePro ($2 in chips) 
Seat 4: drakosveta ($0.42 in chips) 
Seat 5: Tassinari_86 ($4.24 in chips) 
Seat 6: Benzer586 ($2.30 in chips) 
S.Czek: posts small blind $0.01
RedWhitePro: posts big blind $0.02
*** HOLE CARDS ***
Dealt to Benzer586 [As Th]
drakosveta: calls $0.02
Tassinari_86: folds 
Benzer586: calls $0.02
veltern: calls $0.02
S.Czek: folds 
RedWhitePro: checks 
*** FLOP *** [Ad Ks 7d]
RedWhitePro: checks 
drakosveta: checks 
Benzer586: bets $0.05
veltern: folds 
RedWhitePro: folds 
drakosveta: folds 
Uncalled bet ($0.05) returned to Benzer586
Benzer586 collected $0.09 from pot
Benzer586: doesn't show hand 
*** SUMMARY ***
Total pot $0.09 | Rake $0 
Board [Ad Ks 7d]
Seat 1: veltern (button) folded on the Flop
Seat 2: S.Czek (small blind) folded before Flop
Seat 3: RedWhitePro (big blind) folded on the Flop
Seat 4: drakosveta folded on the Flop
Seat 5: Tassinari_86 folded before Flop (didn't bet)
Seat 6: Benzer586 collected ($0.09)



PokerStars Hand #208659327319:  Hold'em No Limit ($0.01/$0.02 USD) - 2020/01/29 20:28:55 WET [2020/01/29 15:28:55 ET]
Table 'Brunonia IV' 6-max Seat #2 is the button
Seat 1: veltern ($1.62 in chips) 
Seat 2: S.Czek ($2.01 in chips) 
Seat 3: RedWhitePro ($2 in chips) 
Seat 4: drakosveta ($0.40 in chips) 
Seat 5: Tassinari_86 ($4.24 in chips) 
Seat 6: Benzer586 ($2.37 in chips) 
RedWhitePro: posts small blind $0.01
drakosveta: posts big blind $0.02
*** HOLE CARDS ***
Dealt to Benzer586 [7h 8h]
Tassinari_86: raises $0.04 to $0.06
Benzer586: folds 
veltern: folds 
S.Czek: calls $0.06
RedWhitePro: calls $0.05
drakosveta: calls $0.04
*** FLOP *** [Kc Jh Kh]
RedWhitePro: checks 
drakosveta: checks 
Tassinari_86: bets $0.12
S.Czek: folds 
RedWhitePro: calls $0.12
drakosveta: folds 
*** TURN *** [Kc Jh Kh] [3s]
RedWhitePro: checks 
Tassinari_86: bets $0.23
RedWhitePro: calls $0.23
*** RIVER *** [Kc Jh Kh 3s] [As]
RedWhitePro: checks 
Tassinari_86: checks 
*** SHOW DOWN ***
RedWhitePro: shows [4h Ah] (two pair, Aces and Kings)
Tassinari_86: shows [Ks Tc] (three of a kind, Kings)
Tassinari_86 collected $0.91 from pot
*** SUMMARY ***
Total pot $0.94 | Rake $0.03 
Board [Kc Jh Kh 3s As]
Seat 1: veltern folded before Flop (didn't bet)
Seat 2: S.Czek (button) folded on the Flop
Seat 3: RedWhitePro (small blind) showed [4h Ah] and lost with two pair, Aces and Kings
Seat 4: drakosveta (big blind) folded on the Flop
Seat 5: Tassinari_86 showed [Ks Tc] and won ($0.91) with three of a kind, Kings
Seat 6: Benzer586 folded before Flop (didn't bet)



PokerStars Hand #208659367127:  Hold'em No Limit ($0.01/$0.02 USD) - 2020/01/29 20:30:00 WET [2020/01/29 15:30:00 ET]
Table 'Brunonia IV' 6-max Seat #3 is the button
Seat 1: veltern ($1.62 in chips) 
Seat 2: S.Czek ($1.95 in chips) 
Seat 3: RedWhitePro ($2 in chips) 
Seat 4: drakosveta ($0.34 in chips) 
Seat 5: Tassinari_86 ($4.74 in chips) 
Seat 6: Benzer586 ($2.37 in chips) 
drakosveta: posts small blind $0.01
Tassinari_86: posts big blind $0.02
*** HOLE CARDS ***
Dealt to Benzer586 [4s Jc]
Benzer586: folds 
veltern: folds 
S.Czek: raises $0.04 to $0.06
RedWhitePro: calls $0.06
drakosveta: calls $0.05
Tassinari_86: folds 
*** FLOP *** [2c Qh Tc]
drakosveta: checks 
S.Czek: bets $0.12
RedWhitePro: calls $0.12
drakosveta: folds 
*** TURN *** [2c Qh Tc] [Th]
S.Czek: bets $0.24
RedWhitePro: calls $0.24
*** RIVER *** [2c Qh Tc Th] [3s]
S.Czek: bets $0.34
RedWhitePro: folds 
Uncalled bet ($0.34) returned to S.Czek
S.Czek collected $0.89 from pot
S.Czek: doesn't show hand 
*** SUMMARY ***
Total pot $0.92 | Rake $0.03 
Board [2c Qh Tc Th 3s]
Seat 1: veltern folded before Flop (didn't bet)
Seat 2: S.Czek collected ($0.89)
Seat 3: RedWhitePro (button) folded on the River
Seat 4: drakosveta (small blind) folded on the Flop
Seat 5: Tassinari_86 (big blind) folded before Flop
Seat 6: Benzer586 folded before Flop (didn't bet)



PokerStars Hand #208659393392:  Hold'em No Limit ($0.01/$0.02 USD) - 2020/01/29 20:30:38 WET [2020/01/29 15:30:38 ET]
Table 'Brunonia IV' 6-max Seat #4 is the button
Seat 1: veltern ($1.62 in chips) 
Seat 2: S.Czek ($2.42 in chips) 
Seat 3: RedWhitePro ($2 in chips) 
Seat 4: drakosveta ($0.28 in chips) 
Seat 5: Tassinari_86 ($4.72 in chips) 
Seat 6: Benzer586 ($2.37 in chips) 
Tassinari_86: posts small blind $0.01
Benzer586: posts big blind $0.02
*** HOLE CARDS ***
Dealt to Benzer586 [Qh 8d]
veltern: folds 
S.Czek: folds 
RedWhitePro: folds 
drakosveta: calls $0.02
Tassinari_86: calls $0.01
Benzer586: checks 
*** FLOP *** [9s 4c Ad]
Tassinari_86: checks 
Benzer586: checks 
drakosveta: checks 
*** TURN *** [9s 4c Ad] [2c]
Tassinari_86: checks 
Benzer586: checks 
drakosveta: checks 
*** RIVER *** [9s 4c Ad 2c] [Td]
Tassinari_86: checks 
Benzer586: checks 
drakosveta: checks 
*** SHOW DOWN ***
Tassinari_86: shows [Th 8c] (a pair of Tens)
Benzer586: mucks hand 
drakosveta: mucks hand 
Tassinari_86 collected $0.06 from pot
*** SUMMARY ***
Total pot $0.06 | Rake $0 
Board [9s 4c Ad 2c Td]
Seat 1: veltern folded before Flop (didn't bet)
Seat 2: S.Czek folded before Flop (didn't bet)
Seat 3: RedWhitePro folded before Flop (didn't bet)
Seat 4: drakosveta (button) mucked [Ks Js]
Seat 5: Tassinari_86 (small blind) showed [Th 8c] and won ($0.06) with a pair of Tens
Seat 6: Benzer586 (big blind) mucked [Qh 8d]



PokerStars Hand #208659408005:  Hold'em No Limit ($0.01/$0.02 USD) - 2020/01/29 20:31:02 WET [2020/01/29 15:31:02 ET]
Table 'Brunonia IV' 6-max Seat #5 is the button
Seat 1: veltern ($1.62 in chips) 
Seat 2: S.Czek ($2.42 in chips) 
Seat 3: RedWhitePro ($2 in chips) 
Seat 4: drakosveta ($0.26 in chips) 
Seat 5: Tassinari_86 ($4.76 in chips) 
Seat 6: Benzer586 ($2.35 in chips) 
Benzer586: posts small blind $0.01
veltern: posts big blind $0.02
*** HOLE CARDS ***
Dealt to Benzer586 [4s 7h]
S.Czek: folds 
RedWhitePro: folds 
drakosveta: calls $0.02
Tassinari_86: raises $0.04 to $0.06
Benzer586: folds 
veltern: calls $0.04
drakosveta: calls $0.04
*** FLOP *** [8s 4c 2c]
veltern: bets $0.02
drakosveta: calls $0.02
Tassinari_86: calls $0.02
*** TURN *** [8s 4c 2c] [Kc]
veltern: bets $0.02
drakosveta: folds 
Tassinari_86: calls $0.02
*** RIVER *** [8s 4c 2c Kc] [2h]
veltern: bets $0.02
Tassinari_86: folds 
Uncalled bet ($0.02) returned to veltern
veltern collected $0.28 from pot
veltern: doesn't show hand 
*** SUMMARY ***
Total pot $0.29 | Rake $0.01 
Board [8s 4c 2c Kc 2h]
Seat 1: veltern (big blind) collected ($0.28)
Seat 2: S.Czek folded before Flop (didn't bet)
Seat 3: RedWhitePro folded before Flop (didn't bet)
Seat 4: drakosveta folded on the Turn
Seat 5: Tassinari_86 (button) folded on the River
Seat 6: Benzer586 (small blind) folded before Flop



PokerStars Hand #208659427206:  Hold'em No Limit ($0.01/$0.02 USD) - 2020/01/29 20:31:33 WET [2020/01/29 15:31:33 ET]
Table 'Brunonia IV' 6-max Seat #6 is the button
Seat 1: veltern ($1.80 in chips) 
Seat 2: S.Czek ($2.42 in chips) 
Seat 3: RedWhitePro ($2 in chips) 
Seat 4: drakosveta ($0.18 in chips) 
Seat 5: Tassinari_86 ($4.66 in chips) 
Seat 6: Benzer586 ($2.34 in chips) 
veltern: posts small blind $0.01
S.Czek: posts big blind $0.02
*** HOLE CARDS ***
Dealt to Benzer586 [2h 8c]
RedWhitePro: folds 
drakosveta: calls $0.02
Tassinari_86: folds 
Benzer586: folds 
veltern: calls $0.01
S.Czek: raises $0.06 to $0.08
drakosveta: calls $0.06
veltern: folds 
*** FLOP *** [Th 7d Jc]
S.Czek: bets $0.12
drakosveta: calls $0.10 and is all-in
Uncalled bet ($0.02) returned to S.Czek
*** TURN *** [Th 7d Jc] [6c]
*** RIVER *** [Th 7d Jc 6c] [4c]
*** SHOW DOWN ***
S.Czek: shows [Qd Jd] (a pair of Jacks)
drakosveta: shows [Tc Ah] (a pair of Tens)
S.Czek collected $0.37 from pot
*** SUMMARY ***
Total pot $0.38 | Rake $0.01 
Board [Th 7d Jc 6c 4c]
Seat 1: veltern (small blind) folded before Flop
Seat 2: S.Czek (big blind) showed [Qd Jd] and won ($0.37) with a pair of Jacks
Seat 3: RedWhitePro folded before Flop (didn't bet)
Seat 4: drakosveta showed [Tc Ah] and lost with a pair of Tens
Seat 5: Tassinari_86 folded before Flop (didn't bet)
Seat 6: Benzer586 (button) folded before Flop (didn't bet)



PokerStars Hand #208659452533:  Hold'em No Limit ($0.01/$0.02 USD) - 2020/01/29 20:32:14 WET [2020/01/29 15:32:14 ET]
Table 'Brunonia IV' 6-max Seat #1 is the button
Seat 1: veltern ($1.78 in chips) 
Seat 2: S.Czek ($2.61 in chips) 
Seat 3: RedWhitePro ($2 in chips) 
Seat 5: Tassinari_86 ($4.66 in chips) 
Seat 6: Benzer586 ($2.34 in chips) 
S.Czek: posts small blind $0.01
RedWhitePro: posts big blind $0.02
*** HOLE CARDS ***
Dealt to Benzer586 [Js 5h]
Tassinari_86: folds 
Benzer586: folds 
veltern: calls $0.02
S.Czek: raises $0.08 to $0.10
RedWhitePro: folds 
veltern: calls $0.08
*** FLOP *** [2d Qs Td]
S.Czek: bets $0.14
veltern: calls $0.14
*** TURN *** [2d Qs Td] [4c]
S.Czek: bets $0.28
veltern: folds 
Uncalled bet ($0.28) returned to S.Czek
S.Czek collected $0.48 from pot
S.Czek: doesn't show hand 
*** SUMMARY ***
Total pot $0.50 | Rake $0.02 
Board [2d Qs Td 4c]
Seat 1: veltern (button) folded on the Turn
Seat 2: S.Czek (small blind) collected ($0.48)
Seat 3: RedWhitePro (big blind) folded before Flop
Seat 5: Tassinari_86 folded before Flop (didn't bet)
Seat 6: Benzer586 folded before Flop (didn't bet)



PokerStars Hand #208659481004:  Hold'em No Limit ($0.01/$0.02 USD) - 2020/01/29 20:33:01 WET [2020/01/29 15:33:01 ET]
Table 'Brunonia IV' 6-max Seat #2 is the button
Seat 1: veltern ($1.54 in chips) 
Seat 2: S.Czek ($2.85 in chips) 
Seat 3: RedWhitePro ($2 in chips) 
Seat 5: Tassinari_86 ($4.66 in chips) 
Seat 6: Benzer586 ($2.34 in chips) 
RedWhitePro: posts small blind $0.01
drakosveta is disconnected 
Tassinari_86: posts big blind $0.02
*** HOLE CARDS ***
Dealt to Benzer586 [8s Js]
Benzer586: folds 
veltern: raises $0.02 to $0.04
S.Czek: folds 
RedWhitePro: calls $0.03
Tassinari_86: calls $0.02
*** FLOP *** [3h Td 9s]
RedWhitePro: bets $0.06
Tassinari_86: calls $0.06
veltern: raises $0.06 to $0.12
RedWhitePro: calls $0.06
Tassinari_86: calls $0.06
*** TURN *** [3h Td 9s] [Qs]
RedWhitePro: checks 
Tassinari_86: checks 
veltern: bets $0.23
RedWhitePro: calls $0.23
Tassinari_86: folds 
*** RIVER *** [3h Td 9s Qs] [Kh]
RedWhitePro: bets $1.61 and is all-in
veltern: calls $1.15 and is all-in
Uncalled bet ($0.46) returned to RedWhitePro
*** SHOW DOWN ***
RedWhitePro: shows [7s Jh] (a straight, Nine to King)
veltern: shows [Ts Tc] (three of a kind, Tens)
RedWhitePro collected $3.13 from pot
*** SUMMARY ***
Total pot $3.24 | Rake $0.11 
Board [3h Td 9s Qs Kh]
Seat 1: veltern showed [Ts Tc] and lost with three of a kind, Tens
Seat 2: S.Czek (button) folded before Flop (didn't bet)
Seat 3: RedWhitePro (small blind) showed [7s Jh] and won ($3.13) with a straight, Nine to King
Seat 5: Tassinari_86 (big blind) folded on the Turn
Seat 6: Benzer586 folded before Flop (didn't bet)



PokerStars Hand #208659516274:  Hold'em No Limit ($0.01/$0.02 USD) - 2020/01/29 20:33:52 WET [2020/01/29 15:33:52 ET]
Table 'Brunonia IV' 6-max Seat #3 is the button
Seat 2: S.Czek ($2.85 in chips) 
Seat 3: RedWhitePro ($3.59 in chips) 
Seat 5: Tassinari_86 ($4.50 in chips) 
Seat 6: Benzer586 ($2.34 in chips) 
Tassinari_86: posts small blind $0.01
Benzer586: posts big blind $0.02
*** HOLE CARDS ***
Dealt to Benzer586 [Jd Kc]
S.Czek: folds 
RedWhitePro: raises $0.02 to $0.04
Tassinari_86: raises $0.14 to $0.18
veltern said, "gz"
Benzer586: folds 
RedWhitePro: calls $0.14
*** FLOP *** [8s 5s 2s]
Tassinari_86: checks 
RedWhitePro: checks 
*** TURN *** [8s 5s 2s] [9s]
Tassinari_86: checks 
RedWhitePro: checks 
*** RIVER *** [8s 5s 2s 9s] [7h]
Tassinari_86: bets $0.30
RedWhitePro: calls $0.30
*** SHOW DOWN ***
Tassinari_86: shows [Ah Qs] (a flush, Queen high)
RedWhitePro: mucks hand 
Tassinari_86 collected $0.95 from pot
*** SUMMARY ***
Total pot $0.98 | Rake $0.03 
Board [8s 5s 2s 9s 7h]
Seat 2: S.Czek folded before Flop (didn't bet)
Seat 3: RedWhitePro (button) mucked [Jc Js]
Seat 5: Tassinari_86 (small blind) showed [Ah Qs] and won ($0.95) with a flush, Queen high
Seat 6: Benzer586 (big blind) folded before Flop



PokerStars Hand #208659537293:  Hold'em No Limit ($0.01/$0.02 USD) - 2020/01/29 20:34:26 WET [2020/01/29 15:34:26 ET]
Table 'Brunonia IV' 6-max Seat #5 is the button
Seat 2: S.Czek ($2.85 in chips) 
Seat 3: RedWhitePro ($3.11 in chips) 
Seat 5: Tassinari_86 ($4.97 in chips) 
Seat 6: Benzer586 ($2.32 in chips) 
Benzer586: posts small blind $0.01
S.Czek: posts big blind $0.02
*** HOLE CARDS ***
Dealt to Benzer586 [Kd Qd]
RedWhitePro: folds 
Tassinari_86: raises $0.04 to $0.06
Benzer586: calls $0.05
S.Czek: folds 
*** FLOP *** [Jc Ac Th]
Benzer586: bets $0.07
Tassinari_86: folds 
Uncalled bet ($0.07) returned to Benzer586
Benzer586 collected $0.14 from pot
Benzer586: doesn't show hand 
*** SUMMARY ***
Total pot $0.14 | Rake $0 
Board [Jc Ac Th]
Seat 2: S.Czek (big blind) folded before Flop
Seat 3: RedWhitePro folded before Flop (didn't bet)
Seat 5: Tassinari_86 (button) folded on the Flop
Seat 6: Benzer586 (small blind) collected ($0.14)



PokerStars Hand #208659548263:  Hold'em No Limit ($0.01/$0.02 USD) - 2020/01/29 20:34:44 WET [2020/01/29 15:34:44 ET]
Table 'Brunonia IV' 6-max Seat #6 is the button
Seat 2: S.Czek ($2.83 in chips) 
Seat 3: RedWhitePro ($3.11 in chips) 
Seat 5: Tassinari_86 ($4.91 in chips) 
Seat 6: Benzer586 ($2.40 in chips) 
S.Czek: posts small blind $0.01
RedWhitePro: posts big blind $0.02
*** HOLE CARDS ***
Dealt to Benzer586 [Qh 4c]
Tassinari_86: folds 
Benzer586: folds 
S.Czek: folds 
Uncalled bet ($0.01) returned to RedWhitePro
RedWhitePro collected $0.02 from pot
*** SUMMARY ***
Total pot $0.02 | Rake $0 
Seat 2: S.Czek (small blind) folded before Flop
Seat 3: RedWhitePro (big blind) collected ($0.02)
Seat 5: Tassinari_86 folded before Flop (didn't bet)
Seat 6: Benzer586 (button) folded before Flop (didn't bet)



PokerStars Hand #208659551867:  Hold'em No Limit ($0.01/$0.02 USD) - 2020/01/29 20:34:50 WET [2020/01/29 15:34:50 ET]
Table 'Brunonia IV' 6-max Seat #2 is the button
Seat 2: S.Czek ($2.82 in chips) 
Seat 3: RedWhitePro ($3.12 in chips) 
Seat 5: Tassinari_86 ($4.91 in chips) 
Seat 6: Benzer586 ($2.40 in chips) 
RedWhitePro: posts small blind $0.01
Tassinari_86: posts big blind $0.02
*** HOLE CARDS ***
Dealt to Benzer586 [2h Kd]
Benzer586: folds 
S.Czek: raises $0.04 to $0.06
RedWhitePro: calls $0.05
Tassinari_86: calls $0.04
*** FLOP *** [7c 3h 6c]
RedWhitePro: checks 
Tassinari_86: checks 
S.Czek: bets $0.10
RedWhitePro: folds 
Tassinari_86: calls $0.10
*** TURN *** [7c 3h 6c] [6h]
Tassinari_86: checks 
S.Czek: bets $0.22
Tassinari_86: calls $0.22
*** RIVER *** [7c 3h 6c 6h] [6s]
Tassinari_86: checks 
S.Czek: checks 
*** SHOW DOWN ***
Tassinari_86: shows [5h Th] (three of a kind, Sixes)
S.Czek: shows [7s 8s] (a full house, Sixes full of Sevens)
S.Czek collected $0.79 from pot
*** SUMMARY ***
Total pot $0.82 | Rake $0.03 
Board [7c 3h 6c 6h 6s]
Seat 2: S.Czek (button) showed [7s 8s] and won ($0.79) with a full house, Sixes full of Sevens
Seat 3: RedWhitePro (small blind) folded on the Flop
Seat 5: Tassinari_86 (big blind) showed [5h Th] and lost with three of a kind, Sixes
Seat 6: Benzer586 folded before Flop (didn't bet)



PokerStars Hand #208659571894:  Hold'em No Limit ($0.01/$0.02 USD) - 2020/01/29 20:35:23 WET [2020/01/29 15:35:23 ET]
Table 'Brunonia IV' 6-max Seat #3 is the button
Seat 2: S.Czek ($3.23 in chips) 
Seat 3: RedWhitePro ($3.06 in chips) 
Seat 5: Tassinari_86 ($4.53 in chips) 
Seat 6: Benzer586 ($2.40 in chips) 
Tassinari_86: posts small blind $0.01
Benzer586: posts big blind $0.02
*** HOLE CARDS ***
Dealt to Benzer586 [Jc 9c]
S.Czek: folds 
RedWhitePro: raises $0.03 to $0.05
Tassinari_86: folds 
Benzer586: calls $0.03
*** FLOP *** [Kd Qs 2c]
Benzer586: checks 
RedWhitePro: bets $0.04
Benzer586: folds 
Uncalled bet ($0.04) returned to RedWhitePro
RedWhitePro collected $0.11 from pot
*** SUMMARY ***
Total pot $0.11 | Rake $0 
Board [Kd Qs 2c]
Seat 2: S.Czek folded before Flop (didn't bet)
Seat 3: RedWhitePro (button) collected ($0.11)
Seat 5: Tassinari_86 (small blind) folded before Flop
Seat 6: Benzer586 (big blind) folded on the Flop



PokerStars Hand #208659586427:  Hold'em No Limit ($0.01/$0.02 USD) - 2020/01/29 20:35:47 WET [2020/01/29 15:35:47 ET]
Table 'Brunonia IV' 6-max Seat #5 is the button
Seat 1: veltern ($2 in chips) 
Seat 2: S.Czek ($3.23 in chips) 
Seat 3: RedWhitePro ($3.12 in chips) 
Seat 5: Tassinari_86 ($4.52 in chips) 
Seat 6: Benzer586 ($2.35 in chips) 
Benzer586: posts small blind $0.01
veltern: posts big blind $0.02
*** HOLE CARDS ***
Dealt to Benzer586 [7d Kd]
S.Czek: folds 
RedWhitePro: folds 
Tassinari_86: raises $0.04 to $0.06
Benzer586: folds 
veltern: calls $0.04
*** FLOP *** [2s Jc Ac]
veltern: checks 
Tassinari_86: bets $0.07
veltern: folds 
Uncalled bet ($0.07) returned to Tassinari_86
Tassinari_86 collected $0.13 from pot
Tassinari_86: doesn't show hand 
*** SUMMARY ***
Total pot $0.13 | Rake $0 
Board [2s Jc Ac]
Seat 1: veltern (big blind) folded on the Flop
Seat 2: S.Czek folded before Flop (didn't bet)
Seat 3: RedWhitePro folded before Flop (didn't bet)
Seat 5: Tassinari_86 (button) collected ($0.13)
Seat 6: Benzer586 (small blind) folded before Flop



PokerStars Hand #208659598544:  Hold'em No Limit ($0.01/$0.02 USD) - 2020/01/29 20:36:06 WET [2020/01/29 15:36:06 ET]
Table 'Brunonia IV' 6-max Seat #6 is the button
Seat 1: veltern ($1.94 in chips) 
Seat 2: S.Czek ($3.23 in chips) 
Seat 3: RedWhitePro ($3.12 in chips) 
Seat 5: Tassinari_86 ($4.59 in chips) 
Seat 6: Benzer586 ($2.34 in chips) 
veltern: posts small blind $0.01
S.Czek: posts big blind $0.02
*** HOLE CARDS ***
Dealt to Benzer586 [Ac 3h]
RedWhitePro: folds 
Tassinari_86: folds 
Benzer586: calls $0.02
veltern: folds 
S.Czek: checks 
*** FLOP *** [9d Jc 2h]
S.Czek: bets $0.04
Benzer586: folds 
Uncalled bet ($0.04) returned to S.Czek
S.Czek collected $0.05 from pot
S.Czek: doesn't show hand 
*** SUMMARY ***
Total pot $0.05 | Rake $0 
Board [9d Jc 2h]
Seat 1: veltern (small blind) folded before Flop
Seat 2: S.Czek (big blind) collected ($0.05)
Seat 3: RedWhitePro folded before Flop (didn't bet)
Seat 5: Tassinari_86 folded before Flop (didn't bet)
Seat 6: Benzer586 (button) folded on the Flop



PokerStars Hand #208659610463:  Hold'em No Limit ($0.01/$0.02 USD) - 2020/01/29 20:36:25 WET [2020/01/29 15:36:25 ET]
Table 'Brunonia IV' 6-max Seat #2 is the button
Seat 2: S.Czek ($3.26 in chips) 
Seat 3: RedWhitePro ($3.12 in chips) 
Seat 6: Benzer586 ($2.32 in chips) 
RedWhitePro: posts small blind $0.01
Tassinari_86: is sitting out 
Benzer586: posts big blind $0.02
*** HOLE CARDS ***
Dealt to Benzer586 [4h 6d]
S.Czek: raises $0.04 to $0.06
Tassinari_86 leaves the table
veltern leaves the table
RedWhitePro: calls $0.05
Benzer586: folds 
*** FLOP *** [Js 4c 5h]
RedWhitePro: checks 
S.Czek: bets $0.08
RedWhitePro: folds 
Uncalled bet ($0.08) returned to S.Czek
S.Czek collected $0.14 from pot
S.Czek: doesn't show hand 
*** SUMMARY ***
Total pot $0.14 | Rake $0 
Board [Js 4c 5h]
Seat 2: S.Czek (button) collected ($0.14)
Seat 3: RedWhitePro (small blind) folded on the Flop
Seat 6: Benzer586 (big blind) folded before Flop



PokerStars Hand #208659619825:  Hold'em No Limit ($0.01/$0.02 USD) - 2020/01/29 20:36:40 WET [2020/01/29 15:36:40 ET]
Table 'Brunonia IV' 6-max Seat #3 is the button
Seat 2: S.Czek ($3.34 in chips) 
Seat 3: RedWhitePro ($3.06 in chips) 
Seat 6: Benzer586 ($2.30 in chips) 
Benzer586: posts small blind $0.01
S.Czek: posts big blind $0.02
*** HOLE CARDS ***
Dealt to Benzer586 [Jd 9h]
RedWhitePro: folds 
Benzer586: calls $0.01
S.Czek: checks 
*** FLOP *** [Ad As Qc]
Benzer586: checks 
S.Czek: checks 
*** TURN *** [Ad As Qc] [2d]
Benzer586: checks 
S.Czek: checks 
*** RIVER *** [Ad As Qc 2d] [7d]
Benzer586: checks 
S.Czek: checks 
*** SHOW DOWN ***
Benzer586: shows [Jd 9h] (a pair of Aces)
S.Czek: shows [4s Kc] (a pair of Aces - King kicker)
S.Czek collected $0.04 from pot
*** SUMMARY ***
Total pot $0.04 | Rake $0 
Board [Ad As Qc 2d 7d]
Seat 2: S.Czek (big blind) showed [4s Kc] and won ($0.04) with a pair of Aces
Seat 3: RedWhitePro (button) folded before Flop (didn't bet)
Seat 6: Benzer586 (small blind) showed [Jd 9h] and lost with a pair of Aces



PokerStars Hand #208659631511:  Hold'em No Limit ($0.01/$0.02 USD) - 2020/01/29 20:36:59 WET [2020/01/29 15:36:59 ET]
Table 'Brunonia IV' 6-max Seat #2 is the button
Seat 2: S.Czek ($3.36 in chips) 
Seat 6: Benzer586 ($2.28 in chips) 
S.Czek: posts small blind $0.01
RedWhitePro: is sitting out 
Benzer586: posts big blind $0.02
*** HOLE CARDS ***
Dealt to Benzer586 [Td Ts]
S.Czek: folds 
Uncalled bet ($0.01) returned to Benzer586
RedWhitePro leaves the table
Benzer586 collected $0.02 from pot
drakosveta was removed from the table for failing to post
drakosveta leaves the table
Benzer586: doesn't show hand 
*** SUMMARY ***
Total pot $0.02 | Rake $0 
Seat 2: S.Czek (button) (small blind) folded before Flop
Seat 6: Benzer586 (big blind) collected ($0.02)



PokerStars Hand #208659634398:  Hold'em No Limit ($0.01/$0.02 USD) - 2020/01/29 20:37:04 WET [2020/01/29 15:37:04 ET]
Table 'Brunonia IV' 6-max Seat #6 is the button
Seat 2: S.Czek ($3.35 in chips) 
Seat 6: Benzer586 ($2.29 in chips) 
Benzer586: posts small blind $0.01
S.Czek: posts big blind $0.02
*** HOLE CARDS ***
Dealt to Benzer586 [Jd Qh]
Benzer586: raises $0.02 to $0.04
S.Czek: folds 
Uncalled bet ($0.02) returned to Benzer586
Benzer586 collected $0.04 from pot
Benzer586: doesn't show hand 
*** SUMMARY ***
Total pot $0.04 | Rake $0 
Seat 2: S.Czek (big blind) folded before Flop
Seat 6: Benzer586 (button) (small blind) collected ($0.04)



PokerStars Hand #208659639295:  Hold'em No Limit ($0.01/$0.02 USD) - 2020/01/29 20:37:12 WET [2020/01/29 15:37:12 ET]
Table 'Brunonia IV' 6-max Seat #2 is the button
Seat 2: S.Czek ($3.33 in chips) 
Seat 6: Benzer586 ($2.31 in chips) 
S.Czek: posts small blind $0.01
Benzer586: posts big blind $0.02
*** HOLE CARDS ***
Dealt to Benzer586 [As 7s]
S.Czek: raises $0.02 to $0.04
Benzer586: raises $0.02 to $0.06
S.Czek: calls $0.02
*** FLOP *** [Ad 7c 4c]
Benzer586: bets $0.06
S.Czek: folds 
Uncalled bet ($0.06) returned to Benzer586
Benzer586 collected $0.12 from pot
Benzer586: doesn't show hand 
*** SUMMARY ***
Total pot $0.12 | Rake $0 
Board [Ad 7c 4c]
Seat 2: S.Czek (button) (small blind) folded on the Flop
Seat 6: Benzer586 (big blind) collected ($0.12)



PokerStars Hand #208659657022:  Hold'em No Limit ($0.01/$0.02 USD) - 2020/01/29 20:37:30 WET [2020/01/29 15:37:30 ET]
Table 'Brunonia IV' 6-max Seat #6 is the button
Seat 2: S.Czek ($3.27 in chips) 
Seat 6: Benzer586 ($2.37 in chips) 
Benzer586: posts small blind $0.01
S.Czek: posts big blind $0.02
*** HOLE CARDS ***
Dealt to Benzer586 [Kc 8s]
Benzer586: calls $0.01
S.Czek: checks 
*** FLOP *** [4s 7h Qd]
S.Czek: checks 
Benzer586: checks 
*** TURN *** [4s 7h Qd] [3c]
S.Czek: checks 
Benzer586: checks 
*** RIVER *** [4s 7h Qd 3c] [5h]
S.Czek: checks 
Benzer586: checks 
*** SHOW DOWN ***
S.Czek: shows [9s 5s] (a pair of Fives)
Benzer586: mucks hand 
S.Czek collected $0.04 from pot
*** SUMMARY ***
Total pot $0.04 | Rake $0 
Board [4s 7h Qd 3c 5h]
Seat 2: S.Czek (big blind) showed [9s 5s] and won ($0.04) with a pair of Fives
Seat 6: Benzer586 (button) (small blind) mucked [Kc 8s]



